al	Kebi
R.M.	Satu kata bertitik
Saura	NLTK
Claire	NLTK
Anil	Kebi
Kuini	Kebi
Tano	NLTK
Blanca	NLTK
Elijah	NLTK
Agra	NLTK
Laine	NLTK
Brendan	NLTK
Ness	NLTK
Josephine	NLTK
Knudsen	NLTK
Francis	NLTK
Harry	NLTK
Delia	NLTK
Byron	NLTK
Silva	NLTK
Eva	NLTK
Sarah	NLTK
Rosario	Kebi
Ibra	Kebi
NSG	Huruf Besar Semua
Bawa	Kebi
Guan	NLTK
Minimal	Kebi
SWAMI	NLTK
Eduardo	NLTK
Jef	NLTK
Messing	NLTK
Rainer	NLTK
Mestika	Kebi
Nicky	NLTK
M	NLTK
Christ	NLTK
Helm	Kebi
Degan	Kebi
Bridget	NLTK
Daya	Kebi
Morgan	NLTK
Immobile	NLTK
Betty	NLTK
Tasrif	Kebi
Buck	NLTK
Senses	Keulang
U.	Satu kata bertitik
Diah	Kebi
Eru	Kebi
Rip	NLTK
diri	Kebi
Lyra	NLTK
Thatcher	NLTK
Kroto	Kebi
Audio	Kebi
Karya	Kebi
Ocean	NLTK
Sir	Kebi
Wanda	Kebi
Cartier	NLTK
Chloe	NLTK
Hetty	NLTK
Carcass	NLTK
Maxwell	NLTK
Cho	NLTK
Rug	NLTK
Rosalind	NLTK
Glean	NLTK
Reiter	NLTK
Singer	NLTK
Jan	NLTK
Mursal	Kebi
Marcello	NLTK
Lemari	Kebi
King	NLTK
Woodrow	NLTK
Paradise	NLTK
Rita	NLTK
Koko	NLTK
Barak	Kebi
Robin	NLTK
Karen	NLTK
Nyak	Kebi
RM.	Satu kata bertitik
Augustin	NLTK
Zak	NLTK
Noble	NLTK
Ike	NLTK
Wallach	NLTK
Winston	NLTK
Mob	Kebi
Bobby	NLTK
Murray	NLTK
Camus	NLTK
Klaus	NLTK
Loris	NLTK
Leak	Kebi
Rafe	Kebi
Daud	NLTK
Bayal	NLTK
Curry	NLTK
JUMP	NLTK
Jennifer	NLTK
Lola	NLTK
R.K.	Satu kata bertitik
Hijab	Kebi
Frank	NLTK
KH.	Satu kata bertitik
Rudolph	NLTK
Andries	NLTK
Longo	Kebi
Heart	NLTK
Luis	NLTK
Vidya	NLTK
Ade	NLTK
Twain	NLTK
Basat	Kebi
Kuman	Kebi
Endang	Kebi
Titi	Kebi
Spence	NLTK
Horst	NLTK
IV	Romawi
Shriver	NLTK
Sulung	Kebi
Stevan	NLTK
Billa	NLTK
Real	Kebi
Aurora	Kebi
Rollo	NLTK
Darwis	Kebi
Donna	NLTK
Sonic	NLTK
Josh	NLTK
Medina	NLTK
Alya	NLTK
Lam	Kebi
Stipe	NLTK
Monteith	NLTK
Georgia	NLTK
Try	NLTK
Sheila	NLTK
Abe	NLTK
Rio	NLTK
Safar	Kebi
Elvira	NLTK
Rai	Kebi
Carter	Kebi
Serse	Kebi
Agam	Kebi
Veronica	NLTK
Bess	NLTK
Hu	NLTK
Lengkong	Kebi
Kuning	Kebi
Rod	NLTK
Theo	NLTK
Fox	NLTK
Michel	NLTK
Negara	Kebi
Peres	Kebi
Static	NLTK
Meg	NLTK
Omer	NLTK
Melik	Kebi
G.	Satu kata bertitik
Antigone	NLTK
Alec	NLTK
Dead	NLTK
Jug	NLTK
Llama	NLTK
Jared	NLTK
SISTAR	Huruf Besar Semua
Shorter	NLTK
Muslim	Kebi
Stam	NLTK
Blind	NLTK
Becker	NLTK
Japan	NLTK
XII	Romawi
Abbas	NLTK
Lance	NLTK
Gadis	Kebi
Club	NLTK
Kipa	Kebi
Amelia	NLTK
Tji	NLTK
Duncan	NLTK
Anna	NLTK
Clark	NLTK
Goodman	NLTK
Tania	Kebi
Sea	NLTK
Foo	NLTK
Konstantinos	NLTK
Ulysses	NLTK
Hill	NLTK
Shankar	NLTK
Florent	NLTK
Fuller	NLTK
Rufus	NLTK
Mora	NLTK
June	NLTK
Chase	NLTK
R.	Satu kata bertitik
Frazer	NLTK
M.T.	Satu kata bertitik
Shola	NLTK
Glazer	NLTK
Ferguson	NLTK
Blur	NLTK
Gradasi	Kebi
Pure	Kebi
Tike	Kebi
tiga	Kebi
Asbak	Kebi
Webber	NLTK
Guram	Kebi
Cast	NLTK
Gertrude	NLTK
Palun	Kebi
Guillermo	NLTK
Pena	Kebi
Peron	Kebi
Siddhartha	NLTK
Mills	Keulang
Lu	Kebi
Kalashnikov	NLTK
Saa	NLTK
Cow	NLTK
Dadali	Kebi
Melon	NLTK
God	NLTK
Mamie	NLTK
Chol	NLTK
Anon	NLTK
Mascara	NLTK
Beatrice	NLTK
Motion	NLTK
Laet	NLTK
Kemal	Kebi
Scrooge	NLTK
Saber	NLTK
Lily	NLTK
Larin	NLTK
Ferri	NLTK
Al	Kebi
Dandi	Kebi
Coates	Keulang
Wolfgang	NLTK
D	NLTK
Chickens	Keulang
Chad	NLTK
Ave	NLTK
Las	Kebi
Schneider	NLTK
Records	Keulang
Davy	NLTK
Lech	NLTK
Abby	NLTK
Bowo	Kebi
Galih	Kebi
Cerci	NLTK
Project	NLTK
Hong	NLTK
Curie	NLTK
Peter	NLTK
Boy	NLTK
Quo	NLTK
Freya	NLTK
Lake	NLTK
Coke	NLTK
Reese	NLTK
Farmer	NLTK
Sersan	Kebi
North	NLTK
Wetter	NLTK
Ante	NLTK
Daman	Kebi
Habib	Kebi
Marvin	NLTK
Trivium	NLTK
Plaza	Kebi
Bolling	NLTK
Maman	Kebi
G.J.	Satu kata bertitik
Octavia	NLTK
Rage	NLTK
Fully	NLTK
Ingram	NLTK
Kinsman	NLTK
Warren	NLTK
Singh	NLTK
Tengku	Kebi
Suk	Kebi
Kaiser	NLTK
Mistry	NLTK
Chico	NLTK
Larry	NLTK
Natalia	NLTK
Markis	Kebi
Cortez	NLTK
Belinda	NLTK
Zein	NLTK
Arrowsmith	NLTK
Electra	NLTK
Note	NLTK
Luna	NLTK
Evangeline	NLTK
Alvin	NLTK
Arwana	Kebi
Christian	NLTK
Biz	NLTK
Silvia	NLTK
Tunggang	Kebi
Luther	NLTK
Book	NLTK
Kota	Kebi
APT	NLTK
Gamal	Kebi
Wall	NLTK
Q	NLTK
Lisa	NLTK
Justine	NLTK
Becky	NLTK
Debbie	NLTK
Brood	NLTK
Giri	Kebi
Jet	Kebi
Brunt	NLTK
Diamond	NLTK
Kanjeng	Kebi
Zakiah	Kebi
Bianchi	NLTK
Bando	Kebi
Liv	NLTK
Nick	NLTK
Giuseppe	NLTK
Bilal	Kebi
Close	NLTK
Aban	Kebi
Sebastian	NLTK
Perdana	Kebi
Insigne	NLTK
Damon	NLTK
Thirteen	NLTK
Arya	Kebi
hitam	Kebi
Agre	NLTK
Tabitha	NLTK
Funk	NLTK
Pike	Kebi
Graham	NLTK
Irama	Kebi
Alpha	NLTK
Ron	NLTK
Alf	Kebi
Monica	NLTK
Kusuma	Kebi
Leter	Kebi
Alo	NLTK
Goo	NLTK
Dt.	Satu kata bertitik
Scott	NLTK
Rijal	Kebi
Kandel	Kebi
Bam	Kebi
Angula	NLTK
Manda	Kebi
Capote	NLTK
Keys	Keulang
Dewi	Kebi
Learns	Keulang
Blues	NLTK
Re	Kebi
Marque	NLTK
Matta	NLTK
Jonas	NLTK
Eros	NLTK
la	Kebi
Sakti	Kebi
Presley	NLTK
Buddha	Kebi
Out	NLTK
Mats	NLTK
Olivier	NLTK
Spray	NLTK
Fates	Keulang
Sandal	Kebi
Hough	NLTK
Serge	NLTK
Joy	NLTK
Ion	Kebi
Truth	NLTK
Jesse	NLTK
Vance	NLTK
Ann	NLTK
Archie	NLTK
Balan	Kebi
Jakob	NLTK
Awal	Kebi
Tamam	Kebi
Tate	NLTK
Bush	NLTK
Martinez	NLTK
Teka	Kebi
Mahkota	Kebi
Emmanuel	NLTK
Her	NLTK
Antar	Kebi
Stamp	NLTK
Eliza	NLTK
Tony	NLTK
Bruce	NLTK
Hardy	NLTK
Suzanne	NLTK
Gasser	NLTK
Town	NLTK
Misionaris	Kebi
Sabbath	NLTK
Yeo	NLTK
Alphonso	NLTK
Gula	Kebi
Timur	Kebi
Cork	NLTK
Saki	Kebi
Leigh	NLTK
Edmund	NLTK
Duff	NLTK
Askar	Kebi
Tang	Kebi
Lulu	NLTK
Gajah	Kebi
Ca	Kebi
Vall	NLTK
Juan	NLTK
Chitra	NLTK
Kings	Keulang
Napalm	Kebi
Warning	NLTK
Seaman	NLTK
Tunas	Kebi
Ading	Kebi
Monster	Kebi
Dimple	NLTK
Vadim	NLTK
Lisan	Kebi
Garner	NLTK
Barnabas	NLTK
Stephen	NLTK
Suzy	NLTK
Hina	Kebi
Mubarak	Kebi
Taruna	Kebi
Herd	NLTK
Ito	NLTK
Ayu	Kebi
Kristin	NLTK
Evanescence	NLTK
Islam	Kebi
Evert	NLTK
Russ	NLTK
Winehouse	NLTK
Palermo	NLTK
Cowboy	NLTK
Toledo	NLTK
Oliver	NLTK
Dendi	Kebi
D.o.t	Satu kata bertitik
Tam	Kebi
Bos	Kebi
Home	NLTK
Fifie	NLTK
Sigmund	NLTK
K.K.	Satu kata bertitik
Sen	Kebi
Infanta	NLTK
Andung	Kebi
Heinz	NLTK
Bujang	Kebi
Burn	NLTK
Garrison	NLTK
Ardi	Kebi
Humphrey	NLTK
Kiki	NLTK
Orchestra	NLTK
Radu	Kebi
Niels	NLTK
Boa	NLTK
Psychic	NLTK
Herman	NLTK
B.	Satu kata bertitik
Cempaka	Kebi
Reiner	NLTK
Kang	Kebi
Bracker	NLTK
Gary	NLTK
Tika	Kebi
Pahlavi	NLTK
Ashraf	NLTK
Abbey	NLTK
Andika	Kebi
Ayunda	Kebi
Margarita	NLTK
Murat	NLTK
Sienna	NLTK
Tino	NLTK
Lincoln	NLTK
Base	NLTK
F.H.	Satu kata bertitik
Young	NLTK
Melody.	Satu kata bertitik
Soto	Kebi
Mercer	NLTK
San	NLTK
Kusti	Kebi
Constant	NLTK
Gerard	NLTK
Ric	NLTK
Freddy	NLTK
Damayanti	NLTK
Juvenal	NLTK
Niall	NLTK
JYJ	Huruf Besar Semua
K.N.	Satu kata bertitik
Henry	Kebi
Briggs	NLTK
Wanita	Kebi
Kaku	Kebi
Carole	NLTK
Lex	NLTK
Ni	Kebi
Guz	NLTK
Claudia	NLTK
Leighton	NLTK
Permata	Kebi
Brenda	NLTK
Daphne	NLTK
Zen	NLTK
Yon	NLTK
Darin	NLTK
Sanjay	NLTK
Florian	NLTK
Sulla	NLTK
Pilar	Kebi
YMCK	Huruf Besar Semua
Valencia	NLTK
Nu	Kebi
Way	NLTK
Ramsey	NLTK
Tipper	NLTK
KW	Huruf Besar Semua
Rocker	NLTK
Gilas	Kebi
Piotr	NLTK
Moore	NLTK
Kalas	Kebi
Corpse	NLTK
Golgi	NLTK
Arifin	Kebi
Joe	NLTK
Tan	Kebi
Peto	NLTK
XVIII	Huruf Besar Semua
Tiar	NLTK
Zalim	Kebi
Moral	Kebi
Teng	Kebi
Micah	NLTK
Ken	Kebi
Atomic	NLTK
Carmen	NLTK
Pieter	NLTK
Mimi	Kebi
Omar	NLTK
Eugene	NLTK
Eldin	NLTK
Tanaka	NLTK
Abraham	NLTK
Serdar	NLTK
Mantik	Kebi
Masayu	Kebi
Toby	NLTK
Bounty	NLTK
Markus	NLTK
Cohen	NLTK
Glen	NLTK
Olga	NLTK
Khalifah	Kebi
Sawai	Kebi
Saturday	NLTK
Snoop	NLTK
Cates	Keulang
Skillet	NLTK
Nahas	Kebi
Welling	NLTK
Loy	NLTK
Sekret	Kebi
Joni	NLTK
Zinnia	NLTK
Lilian	NLTK
Joachim	NLTK
Khir	NLTK
Sancho	NLTK
Ming	NLTK
Fatah	Kebi
Coco	NLTK
Firman	NLTK
Butt	NLTK
Wilfred	NLTK
Gamble	NLTK
Randal	NLTK
Jalil	Kebi
Baptis	Kebi
Didik	Kebi
Rajiv	NLTK
Linus	NLTK
Sisi	Kebi
Owen	NLTK
Fitch	NLTK
Gafur	Kebi
Randolph	NLTK
Sync	NLTK
Taro	NLTK
Tanya	Kebi
Sammy	NLTK
Dai	Kebi
Clara	NLTK
Titus	NLTK
Intan	Kebi
Drew	NLTK
Karti	Kebi
Rabin	NLTK
Helena	NLTK
Cesare	NLTK
Landes	Keulang
Burton	NLTK
Choky	NLTK
Gloria	NLTK
Beg	NLTK
Daze	NLTK
Kopral	Kebi
Indiana	NLTK
Mesa	NLTK
Lindsay	NLTK
Ernst	NLTK
Christie	NLTK
Firth	NLTK
Kwan	NLTK
Tandy	NLTK
Rama	Kebi
Foreman	NLTK
Caesar	NLTK
Sompong	Kebi
Dera	Kebi
Meriam	Kebi
Gayatri	NLTK
Valiant	NLTK
Ben	NLTK
Slim	NLTK
Sung	NLTK
Usher	NLTK
Dara	Kebi
Crackdown	NLTK
Adem	Kebi
Donat	Kebi
Porno	Kebi
Finn	NLTK
Domba	Kebi
Bundy	NLTK
W.J.	Satu kata bertitik
Lata	Kebi
Cooper	NLTK
Maharani	Kebi
Mitt	NLTK
Diego	NLTK
By	NLTK
Run-D.M.C.	Satu kata bertitik
Dire	NLTK
Rick	NLTK
Doke	NLTK
Opera	Kebi
Topan	Kebi
Gonzalo	NLTK
Bianca	NLTK
Bebi	Kebi
Revolver	Kebi
Jackson	NLTK
and	NLTK
Nguyen	NLTK
Lula	NLTK
Sewaka	Kebi
Saadah	Kebi
Bony	NLTK
Terrorizer	NLTK
Patrice	NLTK
Stop	Kebi
Umbara	Kebi
Gumbira	Kebi
Dye	NLTK
Predator	Kebi
R.E.	Satu kata bertitik
Anja	Kebi
Sola	NLTK
Platt	NLTK
Leonid	Kebi
Aso	Kebi
City	NLTK
With	NLTK
Giovanni	NLTK
Sidi	Kebi
Coker	NLTK
Julia	NLTK
Gita	Kebi
Kencana	Kebi
Jurnalis	Kebi
Naomi	NLTK
Fendy	NLTK
Grey	NLTK
Dee	NLTK
Chandler	NLTK
MZ	Huruf Besar Semua
Gosling	NLTK
Flea	NLTK
Tripy	NLTK
Sang	Kebi
Fuad	Kebi
Vang	NLTK
Iga	Kebi
Tertius	NLTK
Palmer	NLTK
Woodruff	NLTK
Ferly	NLTK
Ibo	NLTK
Amour	NLTK
Aam	NLTK
Boyce	NLTK
Windsor	NLTK
Kurt	NLTK
Strange	NLTK
Marko	NLTK
Canterbury	NLTK
Sunan	Kebi
Judy	NLTK
Veranda	NLTK
C.T.R.	Satu kata bertitik
Camilla	NLTK
Pipes	Keulang
Elihu	NLTK
Bragi	NLTK
Sadie	NLTK
Yaya	NLTK
Frangipane	NLTK
Buyar	Kebi
Edar	Kebi
Luluk	Kebi
Bullet	NLTK
Tracey	NLTK
Raka	Kebi
Boyer	NLTK
Salmon	Kebi
Fink	NLTK
Jeanne	NLTK
Ujud	Kebi
Mandala	Kebi
Cecilia	NLTK
Soter	NLTK
Swank	NLTK
L.A.	Satu kata bertitik
Christos	NLTK
Bellow	NLTK
Ba	Kebi
Khair	Kebi
Arthur	NLTK
D.M.C.	Satu kata bertitik
Vega	NLTK
Pier	NLTK
Sundari	Kebi
Aria	Kebi
Novo	NLTK
Sidy	NLTK
Flitter	NLTK
Wolfram	Kebi
Keen	NLTK
Andy	NLTK
Brokoli	Kebi
Crouch	NLTK
Ariana	NLTK
Sukma	Kebi
Wahid	Kebi
Head	NLTK
Emir	Kebi
Native	NLTK
A.N.	Satu kata bertitik
DJ	Huruf Besar Semua
Steven	NLTK
Allan	NLTK
Holla	NLTK
Datar	Kebi
Gong	Kebi
Wim	NLTK
Gladys	NLTK
Mailman	NLTK
Phantom	NLTK
Wawa	Kebi
St.	Satu kata bertitik
Levy	NLTK
Joshua	NLTK
Yan	NLTK
Dern	NLTK
Coverage	NLTK
Missy	NLTK
Nane	NLTK
Vela	NLTK
Verre	NLTK
Willow	NLTK
El	Kebi
Vincent	NLTK
Muse	NLTK
Pander	NLTK
Cynthia	NLTK
by	NLTK
Puan	Kebi
Oren	Kebi
Ahmet	NLTK
Sabrina	NLTK
Mr.	Satu kata bertitik
Soldado	NLTK
Bill	NLTK
Clive	NLTK
Randi	Kebi
Silas	NLTK
Eddy	NLTK
Bass	NLTK
Fleming	NLTK
Bumi	Kebi
Jade	NLTK
Hara	Kebi
Mukti	NLTK
Hetman	NLTK
Port	NLTK
Donovan	NLTK
Newton	Kebi
Saka	Kebi
Taras	Kebi
Hummel	NLTK
Rusa	Kebi
in	Kebi
Chow	NLTK
Kadir	Kebi
Chains	Keulang
A.A.	Satu kata bertitik
Petter	NLTK
Kristen	Kebi
Terri	NLTK
Beverly	NLTK
Dudu	Kebi
Sandy	NLTK
Earl	NLTK
Feri	Kebi
Solis	Kebi
Reynold	NLTK
Bebe	Kebi
Everett	NLTK
Kader	Kebi
Topsy	NLTK
Bonnie	NLTK
Jake	NLTK
Princess	NLTK
Heller	NLTK
Tulus	Kebi
Kathleen	NLTK
Iwa	NLTK
Mindi	Kebi
Alan	NLTK
wa	Kebi
Advent	NLTK
Bunton	NLTK
Inisiasi	Kebi
Mariana	NLTK
Mao	NLTK
Permaisuri	Kebi
Murad	Kebi
Janet	NLTK
An	NLTK
Than	NLTK
Monk	NLTK
Weatherly	NLTK
Joanne	NLTK
Temple	NLTK
Helder	NLTK
Lamb	NLTK
Indah	Kebi
Mada	Kebi
Lobo	NLTK
Frederick	NLTK
Geng	Kebi
Wood	NLTK
Antik	Kebi
Okie	NLTK
E.	Satu kata bertitik
Rex	NLTK
Delima	Kebi
Monte	NLTK
Bambang	Kebi
Spiegel	NLTK
Scaloni	NLTK
Revival	NLTK
Kirana	Kebi
Seok	Kebi
Wonder	NLTK
You	NLTK
Hening	Kebi
Styles	Keulang
Punk	Kebi
Neve	NLTK
Fanny	NLTK
Singleton	NLTK
Snicket	NLTK
Baca	Kebi
Elizabeth	NLTK
Turk	NLTK
Loukas	NLTK
Beha	Kebi
Mian	NLTK
Satar	Kebi
Muir	NLTK
Doughty	NLTK
Rory	NLTK
Dini	Kebi
Dude	NLTK
Kafi	Kebi
Main	Kebi
Dolores	NLTK
Douglas	NLTK
Muno	Kebi
Bloc	NLTK
Frances	NLTK
Amy	NLTK
REO	Huruf Besar Semua
Burns	Keulang
Amal	Kebi
Abang	Kebi
Sisters	Keulang
Akmal	Kebi
Moudy	NLTK
Martin	NLTK
Stoker	Kebi
Case	NLTK
Milla	NLTK
Perwira	Kebi
Alain	NLTK
Tao	NLTK
Atef	NLTK
Sambi	Kebi
Bender	NLTK
RS	Huruf Besar Semua
Grosso	NLTK
SMAP	Huruf Besar Semua
Donnie	NLTK
Patel	NLTK
Susi	NLTK
Jean-Pierre	NLTK
Amin	Kebi
Windu	Kebi
Cinderella	NLTK
Falak	Kebi
Serrano	NLTK
Rodney	NLTK
Yuan	NLTK
Count	NLTK
Dozer	NLTK
Gregory	NLTK
Ravin	NLTK
XV	Huruf Besar Semua
Mars	Kebi
Whitehead	NLTK
Found	NLTK
Boys	Keulang
Octave	NLTK
Jean	NLTK
Hide	NLTK
Pitter	NLTK
Pele	NLTK
Sharp	NLTK
MC	Huruf Besar Semua
Earring	NLTK
Kardinal	Kebi
Branch	NLTK
Pine	NLTK
Galt	NLTK
Quiet	NLTK
O	NLTK
Khalifa	NLTK
Moch.	Satu kata bertitik
Sammer	NLTK
Sick	NLTK
Kuan	NLTK
Karina	Kebi
Ruddy	NLTK
Yang	Kebi
Tracy	NLTK
Formica	NLTK
Spice	NLTK
Ton	Kebi
Bukit	Kebi
Luke	NLTK
Zed	NLTK
Maurice	NLTK
Hijau	Kebi
Mona	NLTK
Men	NLTK
Ray	NLTK
Fritz	NLTK
Magic	NLTK
Patria	NLTK
Nako	NLTK
Ava	NLTK
Sonny	NLTK
Gottfried	NLTK
Nye	NLTK
Ahlan	Kebi
Lynn	NLTK
Cilik	Kebi
Sori	Kebi
Nelson	NLTK
Amar	Kebi
Joey	NLTK
Guido	NLTK
Bora	Kebi
Ji	Kebi
Downs	Keulang
Justina	NLTK
Octavian	NLTK
Pete	NLTK
Jose	NLTK
Gale	NLTK
Eta	Kebi
Bacon	NLTK
Green	NLTK
Obi	Kebi
Lux	NLTK
Husbands	Keulang
Rosalia	NLTK
Batari	Kebi
Cello	NLTK
Dani	NLTK
Charlie	NLTK
Tri	NLTK
Syamsu	Kebi
Nur	Kebi
Doe	NLTK
Ansel	NLTK
Lover	NLTK
Rudy	NLTK
Abdu	Kebi
Cowan	NLTK
Elliott	NLTK
Moses	NLTK
Miriam	NLTK
Jun	Kebi
Bartram	NLTK
Brands	Keulang
Ceper	Kebi
Edith	NLTK
Effendi	NLTK
Tumpal	Kebi
Jr.	Satu kata bertitik
Kieran	NLTK
Tanner	NLTK
Dana	Kebi
Tran	NLTK
Vell	NLTK
Washington	NLTK
Clement	NLTK
Blanco	NLTK
Stuart	NLTK
Brothers	Keulang
Harta	Kebi
Barbara	NLTK
Dado	NLTK
Wisdom	NLTK
Carrizo	NLTK
Driver	NLTK
Salim	Kebi
Mutu	Kebi
Morton	NLTK
Ching	NLTK
Tengker	Kebi
Ran	NLTK
Tapping	NLTK
Babu	Kebi
Erik	Kebi
Geraldine	NLTK
Austin	NLTK
Rudi	Kebi
Grace	NLTK
Five	NLTK
Nair	NLTK
Buddy	NLTK
Fana	Kebi
Julian	NLTK
Blunt	NLTK
Warwick	NLTK
Ananta	NLTK
Kembang	Kebi
Toon	NLTK
Cok	Kebi
FX	Huruf Besar Semua
A.R.	Satu kata bertitik
Min	Kebi
Kathy	NLTK
Poppy	NLTK
Akkad	NLTK
Lara	Kebi
ten	NLTK
Carrick	NLTK
Jeremy	NLTK
Groove	NLTK
Sierra	NLTK
Julius	NLTK
Mahmudi	NLTK
Kribo	Kebi
Learn	NLTK
CB	Huruf Besar Semua
Mutiara	Kebi
Carlo	NLTK
Kawin	Kebi
Dominic	NLTK
Beni	Kebi
Skinner	NLTK
Rahmah	Kebi
Rena	Kebi
Sumirat	Kebi
Miranda	NLTK
Sau	Kebi
Mamo	NLTK
Moo	NLTK
Jessie	NLTK
Gunter	NLTK
Erasure	NLTK
Doris	NLTK
MahaDewa	Kebi
Mikael	NLTK
Puspita	Kebi
Cahill	NLTK
Benny	NLTK
Kati	Kebi
Antinous	NLTK
Klem	Kebi
Tanda	Kebi
Weaving	NLTK
Pasha	NLTK
Marco	NLTK
Yudo	Kebi
Bonnet	NLTK
Gregor	NLTK
Jamin	Kebi
Sud	NLTK
Hawer	NLTK
Nugraha	Kebi
Wahyu	Kebi
Meggy	NLTK
Nance	NLTK
Will.i.am	Satu kata bertitik
Del	NLTK
Goran	NLTK
Vives	NLTK
Garang	Kebi
Thema	NLTK
Ryder	NLTK
Addie	NLTK
Burnet	NLTK
Ahmadi	NLTK
As	Kebi
Ibnu	Kebi
Rain	NLTK
Foster	NLTK
Bakar	Kebi
Loo	NLTK
Kyu	NLTK
Amini	NLTK
Eon	Kebi
Cullen	NLTK
Aries	NLTK
Roosevelt	NLTK
Montana	NLTK
Tarzan	Kebi
Mantra	Kebi
Candra	Kebi
Ted	NLTK
Nile	NLTK
Creation	NLTK
Kolo	NLTK
Nini	Kebi
Chamorro	NLTK
Mortimer	NLTK
Item	Kebi
Amir	Kebi
Ratu	Kebi
Jacobus	NLTK
Christina	NLTK
V	Kebi
Martini	Kebi
Bagus	Kebi
Paola	NLTK
Paulus	NLTK
St	NLTK
Durant	NLTK
Baby	NLTK
Car	NLTK
Arenas	Keulang
Joseph	NLTK
Syed	NLTK
G	NLTK
Pascal	NLTK
Kent	NLTK
Chip	NLTK
Hubble	NLTK
Ping	NLTK
Romain	NLTK
Sri	Kebi
Noel	NLTK
Villa	NLTK
Nul	NLTK
Carpenter	NLTK
Santos	NLTK
Brazil	NLTK
Up	NLTK
Guruh	Kebi
Dada	Kebi
Merlin	NLTK
Sa	Kebi
Alim	Kebi
Bahri	Kebi
Barney	NLTK
Jamrud	Kebi
Tukul	Kebi
II	Romawi
Night	NLTK
Cindy	NLTK
Tiffany	NLTK
Ucu	Kebi
Ajun	Kebi
Youth	NLTK
Peri	Kebi
Hay	NLTK
Kabir	Kebi
Si	Kebi
Swedish	NLTK
Sans	NLTK
Lou	NLTK
Yakin	Kebi
Mayang	Kebi
Karim	Kebi
Yam	NLTK
Sabah	Kebi
Trimurti	Kebi
Pedro	NLTK
Shearer	NLTK
Agnes	NLTK
Citra	Kebi
Romney	NLTK
Hin	NLTK
Mikey	NLTK
Pratt	NLTK
Kim	Kebi
Buster	NLTK
KISS	NLTK
Indy	NLTK
Outlandish	NLTK
Bucky	NLTK
Hollo	NLTK
Miki	NLTK
Anggun	Kebi
PAS	Kebi
Dakota	NLTK
Wei	NLTK
Levi	NLTK
Perin	Kebi
Aga	Kebi
Antun	Kebi
Cassius	NLTK
Oleg	NLTK
Torsten	NLTK
Syukur	Kebi
T.A.T.u.	Satu kata bertitik
Girls	Keulang
Susie	NLTK
Crew	NLTK
Drake	NLTK
January	NLTK
Chapman	NLTK
Maksim	Kebi
Snow	NLTK
Priscilla	NLTK
Jos	NLTK
Hip	Kebi
Hud	NLTK
Mater	NLTK
Aulia	Kebi
Gera	Kebi
Gore	NLTK
Java	NLTK
Wen	NLTK
Ernie	NLTK
Steve	NLTK
Shannon	NLTK
Holden	NLTK
Stan	Kebi
Derby	NLTK
Sai	Kebi
Pollock	NLTK
Ole	NLTK
Ho	NLTK
Randa	Kebi
Budiman	Kebi
Hayward	NLTK
Kamal	Kebi
Nicolas	NLTK
Godwin	NLTK
Granat	Kebi
Manul	NLTK
Salam	Kebi
Jin	Kebi
Banks	Keulang
Chili	NLTK
Quagmire	NLTK
B.F.	Satu kata bertitik
Theron	NLTK
Debby	NLTK
Evan	NLTK
Yes	NLTK
Lane	NLTK
Flores	NLTK
Nathanael	NLTK
Rahman	Kebi
Selly	NLTK
Hal	Kebi
Steed	NLTK
Merah	Kebi
Pesek	Kebi
SEAMO	Huruf Besar Semua
Sissy	NLTK
International	NLTK
Marcos	NLTK
Parra	NLTK
B.Z.	Satu kata bertitik
Nebel	NLTK
Coventry	NLTK
JJ	Huruf Besar Semua
Porcupine	NLTK
Willy	NLTK
Dina	Kebi
el	Kebi
Bullock	NLTK
Ya	Kebi
Gene	NLTK
Slovak	NLTK
Maliki	NLTK
Carver	NLTK
Portia	NLTK
Di	Kebi
Z.	Satu kata bertitik
Roderick	NLTK
Lucius	NLTK
Fears	Keulang
Lucia	NLTK
Mammy	NLTK
Daler	NLTK
Nicholas	NLTK
Chain	NLTK
Dae	NLTK
Antonella	NLTK
Nazar	Kebi
Stallman	NLTK
Mai	Kebi
Baldwin	NLTK
Cici	Kebi
Jenna	NLTK
Even	NLTK
Cyrus	NLTK
Bacharach	NLTK
Archibald	NLTK
Afiat	Kebi
Ponce	NLTK
Tilda	NLTK
Ferry	NLTK
Junior	Kebi
Sasa	Kebi
Horner	NLTK
Woon	NLTK
Ellen	NLTK
Cahaya	Kebi
Granit	Kebi
Hunt	NLTK
Velvet	NLTK
Olof	NLTK
Lynne	NLTK
Smit	NLTK
Basa	Kebi
Salma	NLTK
Hogan	NLTK
Benn	NLTK
Angel	Kebi
Dean	NLTK
Prudence	NLTK
Monty	NLTK
Grab	NLTK
Cakra	Kebi
Zach	NLTK
DUARTE	Huruf Besar Semua
Shawn	NLTK
Gabriel	NLTK
XYZ	Huruf Besar Semua
Trump	NLTK
J	NLTK
Brown	NLTK
America	NLTK
Matt	NLTK
Van	NLTK
ZARD	Huruf Besar Semua
Konstantin	NLTK
Mahdi	Kebi
Ma	Kebi
Lembu	Kebi
Moody	NLTK
Tiara	Kebi
Filippo	NLTK
Bani	Kebi
Motte	NLTK
Jonah	NLTK
Chrissie	NLTK
Knight	NLTK
Heng	Kebi
Hugo	NLTK
Irena	NLTK
Badge	NLTK
Ephraim	NLTK
Sigi	Kebi
Chiefs	Keulang
Ramon	NLTK
Seth	NLTK
Bryan	NLTK
Darius	NLTK
Caroline	NLTK
Tukar	Kebi
Panglima	Kebi
Romero	NLTK
Nuri	Kebi
Gunther	NLTK
Brook	NLTK
Anes	NLTK
Fortune	NLTK
Ban	Kebi
Sultan	Kebi
Judas	NLTK
Malaka	Kebi
Senna	NLTK
Savitri	NLTK
Storm	NLTK
Maya	Kebi
Brin	NLTK
Teguh	Kebi
K.Will	Satu kata bertitik
Valentin	NLTK
Supertramp	NLTK
Spelling	NLTK
Heather	NLTK
Mano	NLTK
Asian	NLTK
Elang	Kebi
Emil	NLTK
Tuanku	Kebi
S.	Satu kata bertitik
Lear	NLTK
Les	Kebi
Benson	NLTK
Macan	Kebi
Franklin	NLTK
Irish	NLTK
Putra	Kebi
ABBA	Huruf Besar Semua
Vladislav	NLTK
Wendy	NLTK
Guru	Kebi
Infante	NLTK
Bruno	NLTK
Rahim	Kebi
Lim	NLTK
Seven	NLTK
T.R.I.A.D	Satu kata bertitik
GT	Huruf Besar Semua
Amanda	NLTK
Vita	NLTK
Emery	NLTK
Project.R	Satu kata bertitik
Amoroso	NLTK
Alfonso	NLTK
Garret	NLTK
Frankenstein	NLTK
Komeng	Kebi
Lian	Kebi
MS	Huruf Besar Semua
Nails	Keulang
Frederik	NLTK
Downing	NLTK
Warni	Kebi
Nat	NLTK
Gentile	NLTK
M.	Satu kata bertitik
Barkas	Kebi
Anduk	Kebi
Gil	NLTK
Cherry	NLTK
Putut	Kebi
TIO	Huruf Besar Semua
Sak	Kebi
Ream	NLTK
Vince	NLTK
Vladimir	NLTK
Aksa	Kebi
TVXQ	Huruf Besar Semua
Maro	Kebi
Romaine	NLTK
Booth	NLTK
Tofu	NLTK
Syekh	Kebi
Cabot	NLTK
Cliff	NLTK
Panji	Kebi
E.H.	Satu kata bertitik
Angelica	NLTK
Dunst	NLTK
Once	Kebi
Pata	NLTK
Mino	NLTK
AJ	Huruf Besar Semua
Servet	NLTK
JAM	Kebi
Enes	Kebi
Routh	NLTK
Boyd	NLTK
Stacy	NLTK
School	NLTK
Band	NLTK
Ezekiel	NLTK
Nellie	NLTK
Sabina	NLTK
Welles	Keulang
Safari	Kebi
Rove	NLTK
Toh	Kebi
Space	NLTK
Marah	Kebi
Hikam	Kebi
Milestone	NLTK
Johan	Kebi
Steppe	NLTK
Mahesa	Kebi
Yuki	NLTK
Santiago	NLTK
Cartes	Keulang
Pater	Kebi
Dubs	NLTK
Gama	Kebi
One	NLTK
Wright	NLTK
Joanna	NLTK
Loren	NLTK
Corey	NLTK
Marshal	NLTK
Berry	NLTK
Stella	NLTK
Bong	Kebi
Helen	NLTK
Betet	Kebi
Day	NLTK
Anom	Kebi
Within	NLTK
Virginia	NLTK
Blatter	NLTK
Bahadur	Kebi
Firasat	Kebi
Ash	NLTK
Stefan	NLTK
Kiley	NLTK
Yeni	NLTK
Crane	NLTK
Antara	Kebi
Soul	NLTK
Dominique	NLTK
Ishmael	NLTK
Viva	NLTK
Latif	Kebi
Aqua	NLTK
Hari	Kebi
Abigail	NLTK
Anima	NLTK
Elisabeth	NLTK
Coelho	NLTK
Sumpter	NLTK
R.Hartono	Satu kata bertitik
George	NLTK
Daryl	NLTK
Mahesh	NLTK
Miro	NLTK
Hayes	Keulang
Vivek	NLTK
Hilda	NLTK
Porter	NLTK
Rosemary	NLTK
Jesper	NLTK
Lloyd	NLTK
Bon	Kebi
Friend	NLTK
Monkeys	Keulang
Gana	Kebi
Noah	NLTK
Arne	NLTK
Mesut	Kebi
Mumpuni	Kebi
Temin	Kebi
Timothy	NLTK
Pereira	NLTK
Rode	NLTK
Rose	NLTK
Carlin	NLTK
Diane	NLTK
Diana	NLTK
KRU	Kebi
Wai	Kebi
Chao	NLTK
Soler	NLTK
Shastri	NLTK
Della	NLTK
Wijaya	Kebi
Foray	NLTK
Polen	Kebi
Walker	NLTK
Blaine	NLTK
Norah	NLTK
Terrence	NLTK
Abbie	NLTK
Mann	NLTK
Ezra	NLTK
Taylor	NLTK
Alba	NLTK
Brooke	NLTK
Turut	Kebi
Lean	NLTK
RTM	Huruf Besar Semua
Amil	Kebi
Pied	NLTK
Benjamin	NLTK
Morning	NLTK
Sena	Kebi
Hakim	Kebi
Luce	NLTK
Dooley	NLTK
Eurythmics	NLTK
Petty	NLTK
Aura	Kebi
Kate	Kebi
Christine	NLTK
Maiden	NLTK
Roberto	NLTK
Ge	Kebi
Idola	Kebi
Fajar	Kebi
Walter	NLTK
Agus	Kebi
Persada	Kebi
Mel	Kebi
Paolo	NLTK
Saul	NLTK
Sanders	NLTK
Dudley	NLTK
Winter	Kebi
Bogart	NLTK
Hart	Kebi
KDI	Huruf Besar Semua
Trillo	NLTK
Meles	NLTK
Oda	NLTK
Mas	Kebi
Kamel	NLTK
Gading	Kebi
Raphael	NLTK
Seko	Kebi
Fall	NLTK
Khar	NLTK
Eaves	NLTK
Creed	NLTK
Children	Keulang
Guti	NLTK
Pak	Kebi
Andreas	NLTK
Goodwill	NLTK
Agung	Kebi
Rafik	Kebi
Rima	Kebi
Clavier	NLTK
Doping	Kebi
Rocks	Keulang
Julio	NLTK
Beatrix	NLTK
Sutra	Kebi
Masyarakat	Kebi
Root	NLTK
Electric	NLTK
Pandu	Kebi
Seng	Kebi
Adu	Kebi
Cherubin	NLTK
Bean	NLTK
Vira	NLTK
Kirsten	NLTK
Salva	NLTK
Jay	NLTK
Prince	NLTK
Quicksilver	NLTK
Light	NLTK
Arroyo	NLTK
Kus	Kebi
Rahmatullah	Kebi
Wahib	Kebi
Reeve	NLTK
Anjar	Kebi
Lot	Kebi
Sadin	Kebi
Manga	NLTK
Kathryn	NLTK
P	NLTK
Ana	Kebi
Winger	NLTK
Milner	NLTK
Gani	Kebi
Jessica	NLTK
Maarten	NLTK
Dunne	NLTK
Panca	Kebi
Dangerous	NLTK
Ratna	Kebi
Sidik	Kebi
C.	Satu kata bertitik
Aram	Kebi
Garuda	Kebi
Dyer	NLTK
Gede	Kebi
Vanessa	NLTK
Santa	Kebi
Fosse	NLTK
Keng	Kebi
Kazi	NLTK
Braid	NLTK
Air	Kebi
Arcade	NLTK
MJ	Huruf Besar Semua
Po	Kebi
Boniface	NLTK
Forest	NLTK
Danielle	NLTK
Grot	NLTK
Casey	NLTK
Baxter	NLTK
Haya	NLTK
Ian	NLTK
Rajendra	NLTK
Munch	NLTK
Babel	NLTK
Andam	Kebi
Duta	Kebi
Roda	Kebi
Funky	NLTK
Jorge	NLTK
Karisma	Kebi
Swift	NLTK
Friends	Keulang
Kou	NLTK
Kawan	Kebi
Basta	NLTK
Sahara	Kebi
Hulk	NLTK
Knowledge	NLTK
Korban	Kebi
Duo	NLTK
Ranty	NLTK
Sudi	Kebi
Zamzam	Kebi
Mario	NLTK
Ohm	Kebi
Ilya	NLTK
Heidi	NLTK
Archimedes	NLTK
Bagi	Kebi
Unity	NLTK
Jo	NLTK
Cary	NLTK
Andi	NLTK
Ed	NLTK
Sloan	NLTK
Naik	Kebi
to	Kebi
Cader	NLTK
Violet	Kebi
Cana	NLTK
Trevor	NLTK
Tin	Kebi
Tumpak	Kebi
Sofia	NLTK
Man	Kebi
Faust	NLTK
Dinda	Kebi
Jackman	NLTK
Irfan	NLTK
Takayuki	NLTK
Cook	NLTK
Black	NLTK
Walt	NLTK
Audrey	NLTK
March	NLTK
H.	Satu kata bertitik
Wayne	NLTK
Ruth	NLTK
Can	NLTK
Boris	NLTK
Valentine	NLTK
Raven	NLTK
Gie	NLTK
Tubman	NLTK
Luri	NLTK
M.I.L.K	Satu kata bertitik
Pixie	NLTK
Mang	Kebi
Pompadour	NLTK
Rawa	Kebi
Dirk	NLTK
Pina	NLTK
Bang	Kebi
E.E.	Satu kata bertitik
Kimberly	NLTK
Grazer	NLTK
Damar	Kebi
Meng	NLTK
Rosa	NLTK
Gin	Kebi
Rosetta	NLTK
Till	NLTK
Linden	NLTK
John	NLTK
Syah	Kebi
Dorado	NLTK
TUN	Kebi
Charles	NLTK
Tugas	Kebi
Fu	NLTK
Heinrich	NLTK
Lynch	NLTK
Nan	Kebi
Azali	Kebi
Rachel	NLTK
Jenny	NLTK
Pepe	Kebi
MBLAQ	Huruf Besar Semua
Tanjung	Kebi
Aku	Kebi
Perry	NLTK
Capra	NLTK
Mahardika	Kebi
Omelette	NLTK
Dylan	NLTK
The	NLTK
Chilla	NLTK
Corona	NLTK
Checker	NLTK
Bahar	Kebi
Vaughn	NLTK
Musa	NLTK
Jeffrey	NLTK
Muriel	NLTK
Stone	NLTK
Cetera	Kebi
Judith	NLTK
Damara	NLTK
Die	NLTK
Rosary	NLTK
Susanna	NLTK
Maxim	NLTK
Vic	NLTK
Elm	NLTK
Haji	Kebi
Puspa	Kebi
Universitas	Kebi
Nurmala	Kebi
Bert	NLTK
Michael	NLTK
Kids	NLTK
Reginald	NLTK
te	Kebi
Pu	NLTK
Holt	NLTK
Joel	NLTK
Blair	NLTK
Smith	NLTK
Lay	NLTK
PJ	Huruf Besar Semua
den	Kebi
de	Kebi
Tong	Kebi
Pen	Kebi
Sterling	NLTK
Wilkinson	NLTK
Yew	NLTK
Romance	NLTK
Malih	Kebi
Samak	Kebi
Phoenix	NLTK
Dutra	NLTK
Dike	NLTK
Matti	NLTK
Kuno	Kebi
Untung	Kebi
Zac	NLTK
Juri	Kebi
Abd.Rahim	Satu kata bertitik
Dorman	Kebi
Borne	NLTK
Hind	NLTK
Apam	Kebi
Birch	NLTK
Kudus	Kebi
Kumala	Kebi
AG	Huruf Besar Semua
Ahsan	Kebi
Bailee	NLTK
Floyd	NLTK
Josip	NLTK
III	Romawi
XIII	Romawi
Kees	NLTK
Parfait	NLTK
Aja	Kebi
Tucker	NLTK
Anastasia	NLTK
Mauri	NLTK
Blue	NLTK
Chun	NLTK
Jeanette	NLTK
Kasai	Kebi
Gabor	Kebi
Big	NLTK
Frederica	NLTK
Alex	NLTK
Aki	Kebi
Kangen	Kebi
Dodd	NLTK
Bunda	Kebi
H.O.T.	Satu kata bertitik
Ter	Kebi
Crazy	NLTK
Roque	NLTK
Nala	Kebi
Sevenfold	NLTK
Crimson	NLTK
Herling	NLTK
Mahmud	Kebi
Olaf	NLTK
Freddie	NLTK
Baran	Kebi
Erasmus	NLTK
Beadle	NLTK
Trier	NLTK
Leon	NLTK
Biram	Kebi
Sunny	NLTK
Shin	NLTK
Bowery	NLTK
Fowler	NLTK
Tears	Keulang
Angga	Kebi
Adrenaline	NLTK
Chevalier	NLTK
Dearly	NLTK
Chicha	NLTK
Alberto	NLTK
Degen	Kebi
Tung	Kebi
Ameen	NLTK
Cedric	NLTK
River	NLTK
Elliot	NLTK
Catherine	NLTK
Kok	Kebi
Daun	Kebi
Saleh	Kebi
Ko	NLTK
Cain	NLTK
Leno	NLTK
Bolot	Kebi
Penelope	NLTK
Gigi	Kebi
Aziz	Kebi
York	NLTK
Belle	NLTK
Keita	NLTK
IX	Romawi
Miss	Kebi
Villar	NLTK
Cartwright	NLTK
Saint	NLTK
Milan	NLTK
Cantor	NLTK
Berger	NLTK
Roman	Kebi
H.G.	Satu kata bertitik
Pot	Kebi
Dame	Kebi
Danny	NLTK
Antony	NLTK
Emilia	NLTK
Lucian	NLTK
Rinaldo	NLTK
Tat	NLTK
Morin	NLTK
Malevolent	NLTK
Alejandro	NLTK
Warp	NLTK
Che	NLTK
Kuya	Kebi
Ari	Kebi
Kembara	Kebi
Sting	NLTK
Eric	NLTK
Diesel	Kebi
Lewis	NLTK
Simeon	NLTK
Lady	NLTK
Pane	NLTK
Edo	NLTK
Purnama	Kebi
Sakai	Kebi
Garnet	Kebi
Woe	NLTK
Angels	Keulang
Kenan	Kebi
Railroad	NLTK
Paus	Kebi
Brilliant	NLTK
Keyes	Keulang
Sabino	NLTK
Burr	NLTK
Block	NLTK
Griffin	NLTK
Albee	NLTK
Abidal	NLTK
Island	NLTK
Warman	NLTK
Heath	NLTK
Putri	Kebi
Gamma	Kebi
Inez	NLTK
Taji	Kebi
Paris	Kebi
Kempes	Kebi
Miles	NLTK
Lotte	NLTK
Asa	Kebi
y	NLTK
Narendra	NLTK
Hikmat	Kebi
Uriah	NLTK
Pole	NLTK
Kharisma	Kebi
Jung	Kebi
Kirk	NLTK
Zan	Kebi
Harden	NLTK
Abel	NLTK
Edward	NLTK
Erie	NLTK
Louise	NLTK
Plastic	NLTK
DMM	Huruf Besar Semua
Rolls	Keulang
Rajesh	NLTK
Dying	NLTK
Service	NLTK
Oswald	NLTK
Desi	NLTK
Leman	NLTK
Denis	NLTK
Kano	Kebi
Sawyer	NLTK
Maduro	NLTK
Koki	Kebi
Wes	NLTK
Bottoms	Keulang
Peel	NLTK
Alois	NLTK
Rantau	Kebi
Burt	NLTK
Mursyid	Kebi
Sessions	NLTK
Cathy	NLTK
Just	NLTK
Pringle	NLTK
Zeus	NLTK
Amedeo	NLTK
Seri	Kebi
Dill	NLTK
Bening	Kebi
Almira	NLTK
Tegar	Kebi
Abadi	Kebi
Halim	Kebi
Skee	NLTK
Miguel	NLTK
Oper	Kebi
Goof	NLTK
Ali	Kebi
Athena	NLTK
Kaj	NLTK
Blinder	NLTK
Innocent	NLTK
JB	Huruf Besar Semua
Serigala	Kebi
Superman	NLTK
Savant	NLTK
Santo	Kebi
Alison	NLTK
Oscar	NLTK
Gabe	NLTK
WaT	NLTK
Martial	NLTK
Cone	NLTK
Darnel	NLTK
G.A.	Satu kata bertitik
Portman	NLTK
Ong	Kebi
Norma	Kebi
Laura	NLTK
Angie	NLTK
Swan	NLTK
Lolo	NLTK
Brownback	NLTK
Artha	NLTK
Winnie	NLTK
Bel	Kebi
Marshall	NLTK
Carlos	NLTK
Victoria	NLTK
Stern	NLTK
Park	NLTK
Margaret	NLTK
Todd	NLTK
Amis	Kebi
Nuraga	Kebi
Fan	NLTK
Palar	Kebi
Mori	Kebi
Crom	NLTK
Mark	Kebi
On	Kebi
Sylvia	NLTK
Quinton	NLTK
White	NLTK
Azamat	Kebi
Baron	Kebi
Bunuh	Kebi
Bart	NLTK
Radin	Kebi
Balthasar	NLTK
Lila	Kebi
Vista	Kebi
Li	NLTK
Kyle	NLTK
Nadir	Kebi
Mango	NLTK
Browning	NLTK
Clerk	NLTK
Anthony	NLTK
Biasa	Kebi
Romeo	NLTK
Rebel	NLTK
Palma	Kebi
Angsa	Kebi
Francois	NLTK
Dolls	Keulang
for	NLTK
Good	NLTK
Datuk	Kebi
Pinda	Kebi
Turco	NLTK
Donald	NLTK
Kamil	Kebi
Rica	Kebi
Vital	Kebi
Alchemy	NLTK
Aji	Kebi
Kempot	Kebi
Donal	NLTK
Room	NLTK
Yip	NLTK
Nine	NLTK
Edgar	NLTK
Sali	Kebi
Nepa	NLTK
Julien	NLTK
Esperance	NLTK
Reinhard	NLTK
Jim	Kebi
Sojourner	NLTK
Dahlia	Kebi
Erika	NLTK
Won	NLTK
Alif	Kebi
Pangestu	Kebi
Wang	Kebi
Julie	NLTK
Irvin	NLTK
Griffith	NLTK
Mandra	NLTK
Tudor	NLTK
Wira	Kebi
Power	NLTK
Ralf	NLTK
Bradbury	NLTK
Sari	Kebi
Belay	NLTK
Harris	NLTK
Mari	Kebi
Polk	NLTK
Bunga	Kebi
Savage	NLTK
German	NLTK
INXS	Huruf Besar Semua
Louis	NLTK
Hamzah	Kebi
Mull	NLTK
Kembar	Kebi
Bonet	Kebi
Rasyid	Kebi
Manik	Kebi
Hilary	NLTK
Billy	NLTK
Chin	NLTK
Justice	NLTK
Bun	Kebi
Nova	Kebi
Dixit	NLTK
Rais	Kebi
Merman	NLTK
Non	Kebi
R	NLTK
Jalal	Kebi
Mecca	NLTK
J.K.	Satu kata bertitik
Sue	NLTK
Steno	Kebi
Stoner	NLTK
R.A.	Satu kata bertitik
Muara	Kebi
Timo	NLTK
Balanta	NLTK
Russell	NLTK
Bertha	NLTK
Lax	NLTK
F.	Satu kata bertitik
August	NLTK
Camel	NLTK
Venkata	NLTK
Brained	Keulang
Mong	Kebi
Hasan	Kebi
Ju	NLTK
K	NLTK
Belo	Kebi
Rukiah	Kebi
KH	Huruf Besar Semua
Sid	NLTK
Lukas	NLTK
Kesuma	Kebi
Jive	NLTK
Bode	NLTK
Curtis	NLTK
Alonso	NLTK
Lydia	NLTK
Weeks	Keulang
Juni	Nama Bulan
Henny	NLTK
Sayed	Keulang
Duk	Kebi
Juliana	NLTK
Kung	Kebi
Esa	Kebi
Naif	Kebi
Melati	Kebi
Tipe	Kebi
Roach	NLTK
Dharma	NLTK
Oli	Kebi
Santon	NLTK
Log	Kebi
Saga	Kebi
ANM	Huruf Besar Semua
oleh	Kebi
Teologi	Kebi
Khadam	Kebi
Nam	NLTK
Maggie	NLTK
Setia	Kebi
Karma	Kebi
Bonjol	Kebi
Peyton	NLTK
Den	Kebi
Enteng	Kebi
Colin	NLTK
Coast	NLTK
Rush	NLTK
Bain	Kebi
Jack	NLTK
Fender	NLTK
Teller	NLTK
Cipta	Kebi
Countess	NLTK
Bom	Kebi
Sivan	NLTK
Carmine	NLTK
Dika	NLTK
Jong	NLTK
P.R.	Satu kata bertitik
Anak	Kebi
Jasper	NLTK
Shen	NLTK
Sufi	Kebi
Bonds	Keulang
Flock	NLTK
Habibi	Kebi
Russel	NLTK
Werner	NLTK
Sean	NLTK
Springer	NLTK
Gervais	NLTK
Gerald	NLTK
Chamberlain	NLTK
Herbert	NLTK
Waltz	NLTK
of	NLTK
Koto	NLTK
Trio	Kebi
Kittel	NLTK
E.S.	Satu kata bertitik
Terence	NLTK
Dewa	Kebi
Val	NLTK
Cornelius	NLTK
Marcel	NLTK
Pepper	NLTK
Reasoner	NLTK
Per	Kebi
I	NLTK
Marten	NLTK
Brittany	NLTK
Fei	NLTK
Money	NLTK
Frison	NLTK
Holland	NLTK
Is	NLTK
Diva	NLTK
TLB	Huruf Besar Semua
Sahid	Kebi
Vijay	NLTK
Fortunella	NLTK
Jem	Kebi
Barnard	NLTK
Shamir	NLTK
Jaqueline	NLTK
Yao	NLTK
Sanda	Kebi
Arena	Kebi
Alice	NLTK
Ahmed	NLTK
Sander	NLTK
Pahala	Kebi
Iswara	NLTK
Edwin	NLTK
Marc	NLTK
Wiseman	NLTK
Anton	NLTK
Pranata	Kebi
Butler	NLTK
Machar	NLTK
Gaga	Kebi
Isidore	NLTK
Daniel	NLTK
American	NLTK
Sol	Kebi
Fernando	NLTK
Adil	Kebi
Barry	NLTK
Bhutia	NLTK
Roon	NLTK
JP	Huruf Besar Semua
Samudra	Kebi
Jaime	NLTK
Isra	Kebi
Clinton	NLTK
Ward	NLTK
Kandar	Kebi
Putu	Kebi
Christofer	NLTK
Bah	Kebi
Rainbow	NLTK
Indri	NLTK
F.X.	Satu kata bertitik
Bajang	Kebi
Pascual	NLTK
Tasty	NLTK
Sosiawan	Kebi
Akbar	Kebi
ID	Kebi
Hoddle	NLTK
Perot	Kebi
Very	NLTK
Kanon	Kebi
Cacau	Kebi
Franco	NLTK
Kumai	Kebi
Barber	Kebi
Elle	NLTK
Made	NLTK
Levels	Keulang
Carissa	NLTK
Armida	NLTK
Dr.	Satu kata bertitik
VIII	Romawi
Samuel	NLTK
Yuda	Kebi
Camara	NLTK
Courtney	NLTK
Nia	Kebi
SPYAIR	Huruf Besar Semua
X	Kebi
Yabu	NLTK
Chambers	Keulang
Slater	NLTK
Dal	Kebi
Perrier	NLTK
Glover	NLTK
Kana	Kebi
Pussycat	NLTK
J.	Satu kata bertitik
Sita	Kebi
Jemaah	Kebi
Hurst	NLTK
Jane	NLTK
Khan	NLTK
Philippe	NLTK
Tompel	Kebi
Carl	NLTK
Culver	NLTK
Leah	NLTK
Nira	Kebi
Malai	Kebi
Fanning	NLTK
Short	NLTK
Ronald	NLTK
Katy	NLTK
Udi	Kebi
Craven	NLTK
Lili	Kebi
Kane	Kebi
Ah	Kebi
Winchester	NLTK
Teresa	NLTK
Shadows	Keulang
Mary	NLTK
Happy	NLTK
Bless	NLTK
Sar	Kebi
Duri	Kebi
Buyung	Kebi
Brent	NLTK
Teras	Kebi
Pertiwi	Kebi
Claude	NLTK
Himawan	NLTK
Rand	NLTK
Swami	NLTK
Withers	NLTK
FM	Huruf Besar Semua
Laksamana	Kebi
Bagas	Kebi
Brunet	NLTK
Adnan	Kebi
Earworm	NLTK
PUSHIM	Huruf Besar Semua
Cha	NLTK
Jobs	Keulang
Rudd	NLTK
Moulin	NLTK
Hank	NLTK
Willie	NLTK
Marty	NLTK
Fitri	Kebi
Au	Kebi
Guava	NLTK
Iso	NLTK
Yoga	Kebi
Cox	NLTK
Calvin	NLTK
Pas	Kebi
Topi	Kebi
Kalam	Kebi
Lord	NLTK
Marilyn	NLTK
Clover	NLTK
Duchess	NLTK
Belly	NLTK
Wong	Kebi
Limp	NLTK
Bertrand	NLTK
Florence	NLTK
Chord	NLTK
Tai	NLTK
Tore	NLTK
Hilaria	NLTK
Wu	NLTK
Muda	Kebi
Rather	NLTK
Basir	Kebi
Guana	NLTK
Angela	NLTK
S.O.S	Satu kata bertitik
Annette	NLTK
Hero	Kebi
Dave	NLTK
Cam	Kebi
Cuthbert	NLTK
Kasino	Kebi
Murphy	NLTK
Weekend	NLTK
Boros	Kebi
Ilham	Kebi
Deep	NLTK
Pol	Kebi
Turner	NLTK
Slot	NLTK
Anggara	Kebi
Pat	NLTK
Attar	NLTK
Sha	NLTK
Posey	NLTK
Franc	NLTK
Conte	NLTK
Alicia	NLTK
Alexis	NLTK
Shoji	NLTK
Tain	NLTK
Pullman	NLTK
Overload	NLTK
Pong	NLTK
Rosales	NLTK
Otis	NLTK
Manuel	NLTK
E.C.	Satu kata bertitik
Baruch	NLTK
BR	Huruf Besar Semua
Raymond	NLTK
Dawson	NLTK
Guna	Kebi
Glory	NLTK
Pontus	NLTK
Frog	NLTK
Ki	Kebi
Alen	NLTK
Phillip	NLTK
Kelik	Kebi
N.	Satu kata bertitik
Poe	NLTK
Tera	Kebi
Clayton	NLTK
Naim	Kebi
Cruise	NLTK
Delap	Kebi
Mila	NLTK
Adela	NLTK
Gena	Kebi
Incubus	NLTK
Broccoli	NLTK
Genevieve	NLTK
Manai	Kebi
Tim	Kebi
Began	Keulang
Nathaniel	NLTK
Connie	NLTK
IU	Huruf Besar Semua
Dion	NLTK
Rob	NLTK
Mata	Kebi
Palla	NLTK
Apel	Kebi
Graeme	NLTK
Hutch	NLTK
Daft	NLTK
Melody	NLTK
Queen	NLTK
Card	NLTK
Prima	Kebi
House	NLTK
Garden	NLTK
Malam	Kebi
Prakarsa	Kebi
mileage	NLTK
Wyss	NLTK
Gable	NLTK
Fenny	NLTK
Jam	Kebi
Bravo	NLTK
Mouth	NLTK
Ci	Kebi
Sergei	NLTK
Bunker	Kebi
My	NLTK
Tegal	Kebi
Adelia	NLTK
Greg	NLTK
Ringer	NLTK
Daeng	Kebi
Lawless	NLTK
Hanif	Kebi
Yuris	Kebi
Neil	NLTK
Shirley	NLTK
Lohan	NLTK
Eddie	NLTK
Pierre	NLTK
Caid	NLTK
Mbah	Kebi
Derrick	NLTK
Brad	NLTK
Zahid	Kebi
Laurie	NLTK
Elvis	NLTK
Corinna	NLTK
dal	Kebi
Mile	NLTK
Guyon	Kebi
Demi	Kebi
Bailey	NLTK
Schiavone	NLTK
Tour	NLTK
Dena	Kebi
Karl	NLTK
Gondrong	Kebi
Emily	NLTK
Bose	NLTK
Granger	NLTK
Miller	NLTK
Color	NLTK
Munsyi	Kebi
Elia	NLTK
Death	NLTK
Tress	NLTK
Gladstone	NLTK
Rana	Kebi
Laksmi	Kebi
Kuang	Kebi
Annie	NLTK
MIQ	Huruf Besar Semua
Jacques	NLTK
Toma	NLTK
Koda	Kebi
Hello	NLTK
Shay	NLTK
Axel	NLTK
Agger	NLTK
Lasso	NLTK
Felix	NLTK
Geoffrey	NLTK
Hot	Kebi
Mambo	Kebi
Flo	NLTK
Norbert	NLTK
Sylvan	NLTK
Arif	Kebi
Vino	NLTK
H.M.	Satu kata bertitik
Samantha	NLTK
Kee	NLTK
Conor	NLTK
Hare	NLTK
Hain	NLTK
Delbert	NLTK
Lorraine	NLTK
Adam	NLTK
Dale	NLTK
Pribadi	Kebi
Rum	Kebi
Rimes	Keulang
Ide	Kebi
Darryl	NLTK
May	NLTK
Christophe	NLTK
Barton	NLTK
Melodia	NLTK
Dunlop	NLTK
Kay	NLTK
Kayo	NLTK
Rahul	NLTK
Vicious	NLTK
Nadi	Kebi
Kekal	Kebi
Pearl	NLTK
Deru	Kebi
Katie	NLTK
Ariel	NLTK
Kian	Kebi
Joran	Kebi
Hazard	NLTK
Badawi	NLTK
Sharon	NLTK
Funeral	NLTK
Reed	NLTK
Lala	Kebi
Barrow	NLTK
Two	NLTK
Perch	NLTK
Ku	Kebi
Ida	NLTK
High	NLTK
Rini	Kebi
Woo	NLTK
H.O.T	Satu kata bertitik
Teck	NLTK
Joon	NLTK
Kristiani	Kebi
T.T.	Satu kata bertitik
Dodo	NLTK
Slank	NLTK
Nil	NLTK
Slash	NLTK
Ruby	NLTK
Phoebe	NLTK
Mafia	Kebi
Chester	NLTK
W.D.	Satu kata bertitik
Sanger	NLTK
Johnny	NLTK
Bandang	Kebi
Sunrise	NLTK
Bow	NLTK
Dries	Keulang
Ucok	Kebi
Satria	Kebi
Francisco	NLTK
Efendi	Kebi
Charlene	NLTK
KAT	NLTK
Bae	NLTK
Allen	NLTK
Emma	NLTK
Howard	NLTK
Jaya	Kebi
Pangeran	Kebi
Strong	NLTK
Guns	Keulang
Huh	Kebi
Thierry	NLTK
Burke	NLTK
Dalton	NLTK
Madeline	NLTK
Linda	NLTK
Sala	Kebi
Hysteric	NLTK
Sumitro	NLTK
Tile	Kebi
Matan	Kebi
Semakin	Kebi
EXO	Huruf Besar Semua
Roy	NLTK
Bomber	Kebi
Milo	NLTK
baron	Kebi
DC	Huruf Besar Semua
Hawking	NLTK
Soares	Keulang
Muller	NLTK
Hidayat	Kebi
Madonna	NLTK
Blake	NLTK
Nada	Kebi
Havel	NLTK
Elisha	NLTK
Haab	NLTK
S.K.	Satu kata bertitik
Pasteur	Kebi
Volta	NLTK
Bernard	NLTK
Tyler	NLTK
Reuben	NLTK
Maria	Kebi
Charlotte	NLTK
Mew	NLTK
Vernon	NLTK
Pim	NLTK
Tara	Kebi
Cardona	NLTK
Thalia	NLTK
Sini	Kebi
Puri	Kebi
Rhoda	NLTK
Maud	NLTK
milady	NLTK
Wise	NLTK
Scissor	NLTK
Irving	NLTK
Tata	Kebi
Scotty	NLTK
Tua	Kebi
Daniele	NLTK
R.S.	Satu kata bertitik
Ami	Kebi
Rahmat	Kebi
Padang	Kebi
Asha	NLTK
Jesus	NLTK
Johanna	NLTK
Juang	Kebi
Wichita	NLTK
Pinto	NLTK
Planes	Keulang
Ilia	NLTK
Born	NLTK
Priest	NLTK
Super	Kebi
Timor	NLTK
Costa	NLTK
Marek	NLTK
Lo	Kebi
Hotel	Kebi
Bent	NLTK
Cristina	NLTK
Libby	NLTK
Lawrence	NLTK
Lys	NLTK
Sinaga	Kebi
Melissa	NLTK
Mena	Kebi
Krishna	NLTK
Vampire	NLTK
Juno	NLTK
Katharine	NLTK
Lan	NLTK
Metin	NLTK
Sparrow	NLTK
Sora	NLTK
Jero	Kebi
CN	Huruf Besar Semua
Mercedes	NLTK
Samir	Kebi
Bright	NLTK
Andrew	NLTK
Roger	NLTK
Bird	NLTK
Abu	NLTK
Baltimore	NLTK
Prakash	NLTK
Vina	NLTK
Finch	NLTK
Tomas	NLTK
Breasted	NLTK
Gray	NLTK
Maulana	Kebi
Curver	NLTK
Claudio	NLTK
Killer	NLTK
Fathers	Keulang
Rice	NLTK
Edmond	NLTK
Cuesta	NLTK
E	Kebi
Kitten	NLTK
Rani	Kebi
Trice	NLTK
Bridges	Keulang
West	NLTK
Ivan	NLTK
Both	NLTK
Raja	Kebi
Crosby	NLTK
Lamela	Kebi
Riot	NLTK
Samba	Kebi
Zaman	Kebi
Susumu	NLTK
Fighters	Keulang
Peggy	NLTK
Duda	Kebi
Toldo	NLTK
Squire	NLTK
Prabu	Kebi
Eloge	NLTK
Pelt	NLTK
Augustus	NLTK
BoA	NLTK
Rudolf	NLTK
Bum	Kebi
Numa	NLTK
Cory	NLTK
Ford	NLTK
Boni	NLTK
Aurelia	NLTK
Jean-Christophe	NLTK
Minum	Kebi
Situ	Kebi
Paula	NLTK
Ai	Kebi
Yellow	NLTK
Tusk	NLTK
Cakar	Kebi
Lionel	NLTK
Dunia	Kebi
Proctor	NLTK
Kusen	Kebi
Lago	Kebi
LVT	Huruf Besar Semua
P.V.	Satu kata bertitik
Cyril	NLTK
Chia	NLTK
Scoot	NLTK
Anne	NLTK
Long	Kebi
Paku	Kebi
Katinka	NLTK
Sakura	Kebi
Didong	Kebi
Gendut	Kebi
Hui	NLTK
TOR	NLTK
Jaguar	Kebi
Fetus	Kebi
Apostolos	NLTK
Billie	NLTK
Luka	Kebi
Goni	Kebi
Troy	NLTK
Hein	NLTK
Pardo	NLTK
Jimmy	NLTK
Duma	NLTK
Rie	NLTK
Mini	Kebi
Reis	NLTK
Hoon	NLTK
Tyrone	NLTK
Dr.PM	Satu kata bertitik
Isak	Kebi
Lestari	Kebi
Rebecca	NLTK
Spearing	NLTK
Ganjar	Kebi
Loach	NLTK
Sumbang	Kebi
Aras	Kebi
Jamal	Kebi
Buisson	NLTK
Bennet	NLTK
Revolusi	Kebi
CL	Huruf Besar Semua
Ethan	NLTK
Messenger	NLTK
Gatra	Kebi
Ujang	Kebi
Holiday	NLTK
Martel	NLTK
Jacky	NLTK
Gibson	NLTK
Racer	NLTK
Burgh	NLTK
Mason	Kebi
Senda	Kebi
Durst	NLTK
Curl	NLTK
Steeve	NLTK
Gilles	NLTK
Agatha	NLTK
Tirta	Kebi
Harold	NLTK
Last	NLTK
Vengeance	NLTK
D.O.	Satu kata bertitik
Cut	NLTK
Summers	Keulang
Sun	Kebi
Cicip	Kebi
Frizzy	NLTK
Ne	NLTK
Suri	Kebi
Garth	NLTK
Tatty	NLTK
Cheney	NLTK
Shi	NLTK
Goodyear	NLTK
ZZ	Huruf Besar Semua
Don	Kebi
Tasa	Kebi
Carolyn	NLTK
Ihsan	Kebi
Amos	NLTK
Tampi	Kebi
Bridge	NLTK
Jawed	NLTK
H.C.	Satu kata bertitik
Dik	Kebi
Isaac	NLTK
Nizam	NLTK
Gideon	NLTK
Tari	Kebi
Tobias	NLTK
Oar	NLTK
Berlin	NLTK
Paco	NLTK
Mercury	NLTK
Taur	Kebi
Dalem	Kebi
Zee	NLTK
Speed	NLTK
Nazir	Kebi
Music	NLTK
Zat	Kebi
C.S.	Satu kata bertitik
Rumor	Kebi
Atik	NLTK
SM	Huruf Besar Semua
Lenny	NLTK
Hubert	NLTK
Fare	NLTK
Burgess	NLTK
Dev	NLTK
Yun	NLTK
Jed	NLTK
Tenacious	NLTK
Suryani	Kebi
Owl	NLTK
Wan	Kebi
Jules	NLTK
Reddy	NLTK
Hadji	NLTK
Mus	Kebi
Jeffery	NLTK
Dixie	NLTK
Painter	NLTK
Jude	NLTK
Rubin	Kebi
Capel	NLTK
Chromy	NLTK
Uli	Kebi
Bing	NLTK
Covey	NLTK
Yogi	NLTK
Dennis	NLTK
S.E.S.	Satu kata bertitik
Mega	Kebi
Anderson	NLTK
Papa	Kebi
Chena	NLTK
Tahan	Kebi
Holly	NLTK
Rubik	Kebi
Rock	NLTK
Yap	NLTK
Schreiner	NLTK
EVO	Huruf Besar Semua
Sade	NLTK
Kasih	Kebi
Underwood	NLTK
Reid	NLTK
Sophia	NLTK
Surya	Kebi
Nusa	Kebi
Ella	NLTK
RJ	Huruf Besar Semua
Ae	NLTK
Pee	NLTK
Primus	NLTK
Luc	NLTK
Radek	NLTK
Sani	Kebi
Red	NLTK
Janker	NLTK
Dag	NLTK
Maia	NLTK
Eutanasia	Kebi
Marsha	NLTK
Norman	NLTK
B.o.B	Satu kata bertitik
Bobo	NLTK
Patricio	NLTK
Vai	NLTK
Dieter	NLTK
Bur	Kebi
Danuri	NLTK
Jon	NLTK
Gaskins	NLTK
Jati	Kebi
Untouchable	NLTK
Avian	NLTK
ter	Kebi
Tom	Kebi
Chou	NLTK
Fay	NLTK
Travis	NLTK
Pretty	NLTK
Otto	NLTK
Tiffin	NLTK
Rau	Kebi
Susan	NLTK
Georgie	NLTK
Baba	Kebi
Jussi	NLTK
Child	NLTK
Roses	Keulang
Mulligan	NLTK
Testone	NLTK
Abdi	Kebi
Martha	NLTK
Pia	NLTK
Pantelis	NLTK
Early	NLTK
Wirawan	Kebi
Chaka	NLTK
Rath	NLTK
Taufik	Kebi
Mira	NLTK
Manny	NLTK
Wilhelmina	NLTK
Emerald	NLTK
Erick	NLTK
Tag	NLTK
Mukminin	Kebi
Nurse	NLTK
Cleopatra	NLTK
Hanna	NLTK
Marie	NLTK
Serenade	NLTK
Kan	Kebi
Patil	Kebi
Mok	Kebi
Yok	NLTK
Bayu	Kebi
Dan	Kebi
Sonja	NLTK
Kasim	Kebi
Mayer	NLTK
Morris	NLTK
Bianco	NLTK
Darren	NLTK
Godfrey	NLTK
Karel	NLTK
Ananda	Kebi
Mouly	NLTK
Derek	Kebi
Date	NLTK
Grand	NLTK
Battle	NLTK
Carnegie	NLTK
Alexander	NLTK
Seamus	NLTK
Bryce	NLTK
Huckle	NLTK
Hukum	Kebi
Leo	NLTK
Lois	NLTK
Fabian	NLTK
Mina	Kebi
List	NLTK
F.T.	Satu kata bertitik
Dalia	Kebi
Timbul	Kebi
Waits	Keulang
Harper	NLTK
Yu	Kebi
Syahid	Kebi
Boer	NLTK
Kristian	NLTK
Paulin	NLTK
Marion	NLTK
Selena	NLTK
Kali	Kebi
Sparks	NLTK
Dong	Kebi
Peppers	Keulang
Ring	Kebi
Kartika	Kebi
T.	Satu kata bertitik
Liz	NLTK
Padan	Kebi
Bemba	NLTK
Temptation	NLTK
Mak	Kebi
Kemp	NLTK
Leung	NLTK
Dwayne	NLTK
Bowker	NLTK
Sylva	NLTK
Withe	NLTK
Francisca	NLTK
O.	Satu kata bertitik
VI	Romawi
Hackman	NLTK
Ebenezer	NLTK
Malcolm	NLTK
Irwin	NLTK
Louisa	NLTK
Denys	Keulang
Capa	Kebi
Bowles	Keulang
Dadi	Kebi
Henrietta	NLTK
Train	NLTK
Page	NLTK
Tulung	Kebi
Dewan	Kebi
Bonar	Kebi
Collins	NLTK
Constantine	NLTK
Sami	Kebi
Leopold	NLTK
Mulia	Kebi
Cavendish	NLTK
Basso	NLTK
Hildebrand	NLTK
R.M.S.	Satu kata bertitik
Love	NLTK
Z	NLTK
Brett	NLTK
Little	NLTK
Gun	Kebi
Johann	NLTK
Tamsil	Kebi
Yuri	Kebi
Tema	Kebi
Patricia	NLTK
Calista	NLTK
Gwen	NLTK
Doug	NLTK
Kodi	Kebi
Rupert	NLTK
Stein	NLTK
Inception	NLTK
Flack	NLTK
Parto	NLTK
Russian	NLTK
Taft	NLTK
HW	Huruf Besar Semua
Adlai	NLTK
Bo	NLTK
Lovelock	NLTK
Cool	NLTK
Lambert	Kebi
For	NLTK
Bramble	NLTK
Piper	NLTK
Jill	NLTK
Gal	NLTK
Lightning	NLTK
Marine	Kebi
Stephan	NLTK
Bell	NLTK
Albin	NLTK
Tango	Kebi
Gusti	Kebi
Ok	NLTK
Farouk	NLTK
David	NLTK
Oyong	Kebi
Firdaus	Kebi
Maskara	Kebi
Kit	Kebi
Margie	NLTK
Fred	NLTK
F	NLTK
Bradford	NLTK
Cole	NLTK
Buhl	NLTK
Damme	NLTK
Kama	Kebi
Hana	Kebi
S	Kebi
Ita	NLTK
Syamsir	Kebi
Dicky	NLTK
Sio	Kebi
Astor	NLTK
Demy	NLTK
Basten	NLTK
Doddy	NLTK
Leonard	NLTK
Hugh	NLTK
Chance	NLTK
Amine	NLTK
Cannibal	NLTK
H.M.A.	Satu kata bertitik
Pollack	NLTK
Benward	NLTK
Mara	Kebi
Sherman	NLTK
Johannes	NLTK
E.J.	Satu kata bertitik
Pato	NLTK
Garibaldi	NLTK
Lima	Kebi
Pitau	NLTK
Butane	NLTK
Nara	Kebi
Cornelia	NLTK
Danic	NLTK
Anan	NLTK
Shoes	Keulang
Mohr	NLTK
Rainy	NLTK
Gori	Kebi
Morel	NLTK
Box	Keulang
Randall	NLTK
Kreator	Kebi
Eileen	NLTK
Justin	NLTK
Laurent	NLTK
VII	Romawi
Ham	Kebi
Poco	NLTK
Olson	NLTK
Bintang	Kebi
Gol	Kebi
Antonio	NLTK
Rafael	NLTK
Benedict	NLTK
Bas	Kebi
Nik	Kebi
Kelly	NLTK
Hale	NLTK
Merpati	Kebi
Khalil	Kebi
Graff	NLTK
Chubby	NLTK
Eli	NLTK
Noda	Kebi
Saad	NLTK
Enid	NLTK
Angelo	NLTK
Bukan	Kebi
Given	NLTK
Sebai	Kebi
Guntur	Kebi
Sunu	Kebi
Sally	NLTK
J.G.	Satu kata bertitik
Ethel	NLTK
Nina	NLTK
Nobs	NLTK
Tahir	Kebi
Kasah	Kebi
Art	NLTK
Gilang	Kebi
anugerah	Kebi
Karet	Kebi
Baria	NLTK
Lacks	Keulang
Celia	NLTK
Weber	NLTK
Pape	NLTK
Steer	NLTK
Lester	NLTK
Cindai	Kebi
Mack	NLTK
Dustin	NLTK
Fico	NLTK
Teddy	NLTK
Carol	NLTK
Grange	NLTK
Stewart	NLTK
MahaDewi	Kebi
Medan	Kebi
Arm	NLTK
Bates	Keulang
Jelly	NLTK
Suzan	NLTK
Acoustic	NLTK
Hirofumi	NLTK
Bourdon	NLTK
Matter	NLTK
Suir	Kebi
Woods	Keulang
Epik	Kebi
Mayo	NLTK
Nancy	NLTK
Andrea	NLTK
Burak	Kebi
Sein	Kebi
Levin	NLTK
Raya	Kebi
Titien	NLTK
B	NLTK
Jozy	NLTK
Gamaliel	NLTK
Lew	NLTK
Chris	NLTK
Busby	NLTK
Dayang	Kebi
Inch	NLTK
Chuck	NLTK
Fey	NLTK
Clough	NLTK
Ledger	NLTK
Woody	NLTK
Hermes	NLTK
Generation	NLTK
Walsh	NLTK
Patriark	Kebi
Gunung	Kebi
Party	NLTK
Ernest	NLTK
Bak	Kebi
Petit	NLTK
Puncheon	NLTK
Rian	Kebi
Talib	Kebi
G.H.	Satu kata bertitik
Marian	NLTK
Marina	NLTK
Wilhelm	NLTK
Hopper	NLTK
Perceval	NLTK
Cuts	Keulang
Filo	Kebi
Boston	NLTK
Church	NLTK
Sergiu	NLTK
Raj	NLTK
Asmara	Kebi
Jerun	Kebi
Philip	NLTK
Randy	NLTK
Ladin	NLTK
Bella	NLTK
Pamungkas	Kebi
Immanuel	NLTK
Patrick	NLTK
B.A.P	Satu kata bertitik
Best	NLTK
Nathan	NLTK
Sapta	Kebi
Judi	Kebi
Doyle	NLTK
Aline	NLTK
Ketchup	NLTK
Correa	NLTK
Hiram	NLTK
Thomas	NLTK
Puput	Kebi
Said	Kebi
Jordan	NLTK
Carr	NLTK
Unique	NLTK
Anang	Kebi
Agil	Kebi
Cak	Kebi
Wilson	NLTK
Hope	NLTK
Sandra	Kebi
Hi	Kebi
Keri	Kebi
Song	NLTK
Tatang	Kebi
Naib	Kebi
Wilder	NLTK
Leila	NLTK
Asri	Kebi
Fatima	NLTK
Sr.	Satu kata bertitik
Klasik	Kebi
Konrad	NLTK
di	Kebi
Harvey	NLTK
Group	NLTK
Kelvin	NLTK
Mike	NLTK
Bulan	Kebi
Mae	NLTK
Fletcher	NLTK
Mantilla	NLTK
XO	Huruf Besar Semua
Criss	NLTK
Chick	NLTK
Shandy	NLTK
Zet	Kebi
Prihatin	Kebi
Wolf	NLTK
Anis	Kebi
Marcella	NLTK
Purba	Kebi
Starling	NLTK
Han	NLTK
Ria	Kebi
Sampurna	Kebi
Mat	Kebi
Dragon	Kebi
Feist	NLTK
Kenneth	NLTK
Riley	NLTK
Takeuchi	NLTK
Tani	Kebi
Lie	NLTK
Shan	NLTK
Christopher	NLTK
Arnold	NLTK
Monkey	NLTK
Restu	Kebi
Piet	NLTK
Dwight	NLTK
Hertz	Kebi
Zeta	Kebi
Shun	NLTK
Laurin	NLTK
Amadou	NLTK
Fire	NLTK
Lucy	NLTK
Hatta	Kebi
Ram	Kebi
Cat	Kebi
Slipknot	NLTK
Casper	NLTK
Belcher	NLTK
P.	Satu kata bertitik
Hillel	NLTK
dan	Kebi
Suu	NLTK
Waters	Keulang
Merton	NLTK
Gaspar	NLTK
Urs	NLTK
I.	Satu kata bertitik
Matsu	NLTK
e	Kebi
Wee	NLTK
Joyce	NLTK
Taw	NLTK
Acker	NLTK
Lama	Kebi
Gagap	Kebi
Madame	NLTK
Calmy	NLTK
ADA	Kebi
Golden	NLTK
Ruan	Kebi
Sylvester	NLTK
Beck	NLTK
Tempest	NLTK
Vicky	NLTK
Rutherford	NLTK
Patek	Kebi
Morbid	NLTK
Ralph	NLTK
Joan	NLTK
Hop	Kebi
Suwita	Kebi
Titian	NLTK
Lucky	NLTK
Kahin	Kebi
Berg	NLTK
Michelle	NLTK
Bongo	Kebi
Shaw	NLTK
Lars	Kebi
Map	Kebi
Ball	NLTK
Anas	NLTK
Candy	NLTK
Poulard	NLTK
Atmo	NLTK
Luak	Kebi
Orkes	Kebi
BM.	Satu kata bertitik
Hamilton	NLTK
Polo	Kebi
Lengah	Kebi
Leontin	Kebi
Adrian	NLTK
Punjabi	NLTK
Pica	Kebi
Cate	NLTK
Brewster	NLTK
Keith	NLTK
Ning	Kebi
Lea	NLTK
Dolphin	NLTK
Nelly	NLTK
Crocker	NLTK
Irons	Keulang
Alfred	NLTK
Chang	NLTK
Woodward	NLTK
Jarvis	NLTK
Matthias	NLTK
Helge	NLTK
Atta	NLTK
Fi	NLTK
Sidney	NLTK
Rabi	Kebi
Poulter	NLTK
Iras	Kebi
Lina	NLTK
Boral	NLTK
Liza	NLTK
O.B.	Satu kata bertitik
Eliot	NLTK
MOOMIN	Huruf Besar Semua
Pope	NLTK
Justo	NLTK
K.	Satu kata bertitik
Toro	Kebi
Ibing	Kebi
Fatur	Kebi
Netty	NLTK
Suid	NLTK
Vienna	NLTK
Bishop	NLTK
Paddy	NLTK
Naoto	NLTK
Siti	Kebi
Hung	NLTK
DeMerit	NLTK
Isabelle	NLTK
Dusky	NLTK
Mandi	Kebi
Nuke	NLTK
Bara	Kebi
Palfrey	NLTK
Takdir	Kebi
MH.	Satu kata bertitik
Tarkas	Kebi
Wiji	Kebi
Chinchilla	NLTK
Babys	Keulang
Kubin	Kebi
Hagi	NLTK
Aris	Kebi
Tribe	NLTK
Fisher	NLTK
Aly	NLTK
Status	Kebi
Tess	NLTK
Parker	NLTK
Roberta	NLTK
Astrid	NLTK
Melinda	NLTK
Toto	NLTK
Bloom	NLTK
Shelter	NLTK
Timi	Kebi
Whiting	NLTK
Privat	Kebi
Leslie	NLTK
Theodore	NLTK
Kitty	NLTK
Mami	Kebi
E.A.	Satu kata bertitik
Oh	Kebi
Quintet	NLTK
Tack	NLTK
van	NLTK
Cancer	NLTK
Pical	NLTK
Anita	NLTK
Kotoko	NLTK
Lens	Kebi
Wulan	Kebi
Selva	NLTK
Spike	NLTK
Hillary	NLTK
Avery	NLTK
Brede	NLTK
Hiroyuki	NLTK
Blash	NLTK
William	NLTK
Konan	Kebi
Clift	NLTK
Adipati	Kebi
Hwa	NLTK
Fry	NLTK
Syarif	Kebi
Aung	Kebi
Oskar	NLTK
Schiller	NLTK
Ignatius	NLTK
Hausen	NLTK
Guy	NLTK
Junius	NLTK
Gaus	NLTK
Theobald	NLTK
MZA	Huruf Besar Semua
Dinar	Kebi
Chi	NLTK
Tamara	NLTK
Mudi	Kebi
Natalie	NLTK
Taslim	Kebi
Amara	NLTK
Tyke	NLTK
Vena	Kebi
Malik	Kebi
Hun	Kebi
Plant	NLTK
Bana	NLTK
Radius	Kebi
Sara	Kebi
Eden	NLTK
Dia	Kebi
Elias	NLTK
Yana	NLTK
Secondhand	NLTK
Mahatma	Kebi
Krista	Kebi
Law	NLTK
Mohammad	NLTK
Dorothy	NLTK
Holm	NLTK
Potter	NLTK
Lee	NLTK
Koch	NLTK
Muslimin	Kebi
Conrad	NLTK
Gunawan	Kebi
Skye	NLTK
Derry	NLTK
Rolf	NLTK
Nila	Kebi
Graves	NLTK
Erwin	NLTK
Sage	NLTK
Iman	Kebi
Viola	Kebi
Amat	Kebi
Pussy	NLTK
Grant	NLTK
Victor	NLTK
Artie	NLTK
Evelyn	NLTK
Semak	Kebi
Harmon	NLTK
Gottlieb	NLTK
Merry	NLTK
Pink	NLTK
Nash	NLTK
Abate	NLTK
C.G.E.	Satu kata bertitik
Seme	NLTK
Ricardo	NLTK
Lana	Kebi
Anyang	Kebi
Carrie	NLTK
sang	Kebi
Asking	Keulang
Bay	NLTK
Chinese	NLTK
Hans	NLTK
Mirza	NLTK
Slade	NLTK
Richard	NLTK
Jerry	NLTK
Sook	NLTK
Xi	NLTK
Ivy	NLTK
Yayi	Kebi
Beau	NLTK
AC	Huruf Besar Semua
Lil	Kebi
Stephanie	NLTK
Hiren	NLTK
Lupus	NLTK
Banana	NLTK
Lancaster	NLTK
Boney	NLTK
Will	NLTK
N	NLTK
Carsten	NLTK
Ranger	NLTK
ST	NLTK
Jaja	Kebi
Jonathan	NLTK
Kanda	Kebi
Ludwig	NLTK
Jagger	NLTK
Solar	Kebi
T.B.	Satu kata bertitik
Delapan	Kebi
Cucu	Kebi
Chen	NLTK
Risa	Kebi
Awang	Kebi
Ace	NLTK
Rochelle	NLTK
Parks	Keulang
Jeff	NLTK
Suda	Kebi
Zain	NLTK
Rowland	NLTK
Meri	Kebi
Arango	NLTK
Shire	NLTK
Bertram	NLTK
Lith	NLTK
Lyndon	NLTK
Barel	Kebi
Isabel	NLTK
Martyn	NLTK
Nahak	Kebi
Reda	Kebi
Pennant	NLTK
Oki	NLTK
Fleet	NLTK
Suwandi	NLTK
Pamela	NLTK
Oleh	Kebi
Dora	NLTK
Kara	Kebi
Ary	NLTK
Wage	NLTK
Vindex	NLTK
Lena	Kebi
Go	NLTK
Kat	NLTK
XI	NLTK
Sie	NLTK
Bungsu	Kebi
Lucretia	NLTK
Lusk	NLTK
Ati	Kebi
Gregg	NLTK
Orson	NLTK
Satu	Kebi
Crosse	NLTK
Trinity	NLTK
Neto	Kebi
Kafka	NLTK
Collin	NLTK
Asaph	NLTK
L.	Satu kata bertitik
Nestor	NLTK
Ridder	NLTK
Pierce	NLTK
Bee	NLTK
Bosch	NLTK
Braille	Kebi
Celsius	Kebi
Taufan	Kebi
Begin	NLTK
Manfred	NLTK
Kral	NLTK
Clint	NLTK
Cage	NLTK
Eveline	NLTK
Kui	Kebi
Syd	NLTK
Fakih	Kebi
Irene	NLTK
Canaan	NLTK
Letitia	NLTK
Mitchell	NLTK
Rosier	NLTK
Buchanan	NLTK
Hurley	NLTK
Nana	NLTK
Abul	Kebi
Tora	NLTK
Munshi	NLTK
Orlando	NLTK
Maureen	NLTK
Crow	NLTK
Ross	NLTK
Phil	NLTK
Hammer	NLTK
Banda	Kebi
Ricky	NLTK
Price	NLTK
Lin	Kebi
Rupiah	Kebi
Josiah	NLTK
Max	NLTK
Yo	NLTK
In	Kebi
Rida	Kebi
Moi	NLTK
Muluk	Kebi
Jari	Kebi
Hunter	NLTK
Gus	Kebi
Ragnar	NLTK
Ruak	Kebi
Chetty	NLTK
Robbin	NLTK
Nate	NLTK
Adinda	Kebi
Alexius	NLTK
Back	NLTK
Cecil	NLTK
Bayar	Kebi
Zeppelin	NLTK
TJ	Huruf Besar Semua
A	NLTK
Seymour	NLTK
Aguinaldo	NLTK
Simson	NLTK
Null	NLTK
Karas	Kebi
Dalle	NLTK
Loco	NLTK
Bowie	NLTK
Colt	NLTK
Sinyo	Kebi
Penta	NLTK
Petr	NLTK
Bin	Kebi
Vera	NLTK
Muntu	Kebi
W.	Satu kata bertitik
Tae	NLTK
Lazy	NLTK
Cassandra	NLTK
Barker	NLTK
Nanda	Kebi
Cinta	Kebi
Jamie	NLTK
Vilhelm	NLTK
V.	Satu kata bertitik
Haris	Kebi
Laurence	NLTK
Clarence	NLTK
Heck	NLTK
Lemony	NLTK
Angelina	NLTK
Waterman	NLTK
Terry	NLTK
Chet	NLTK
Sock	NLTK
Ambo	NLTK
Dell	NLTK
Una	NLTK
Soe	Kebi
Galung	Kebi
Baker	NLTK
Juhi	Kebi
Giring	Kebi
Slayer	NLTK
Kevin	NLTK
Samudera	Kebi
Matthew	NLTK
Aaron	NLTK
KM	Huruf Besar Semua
Olla	NLTK
Gish	NLTK
Halo	Kebi
Mick	NLTK
A.S.	Satu kata bertitik
Geoff	NLTK
Alexandra	NLTK
Gillian	NLTK
Gaby	NLTK
Nils	NLTK
Sana	Kebi
Hall	NLTK
Wainwright	NLTK
Bedene	NLTK
Jiwa	Kebi
Key	NLTK
Mashal	NLTK
Cheng	NLTK
Mika	Kebi
Bale	NLTK
Galore	NLTK
Lorenzo	NLTK
Amber	NLTK
Tal	Kebi
H	NLTK
Adriana	NLTK
Jasmine	NLTK
Glenn	NLTK
Colback	NLTK
Pablo	NLTK
Mighty	NLTK
Kelana	Kebi
Kaisar	Kebi
Devon	NLTK
Mi	Kebi
Brian	NLTK
Y.	Satu kata bertitik
Jewel	NLTK
Irma	NLTK
Tek	Kebi
Mahmoud	NLTK
Alien	NLTK
Mulder	NLTK
U	NLTK
J.B.S.	Satu kata bertitik
Bismarck	NLTK
Goma	NLTK
Kin	Kebi
Forman	Kebi
Navy	NLTK
Led	NLTK
He	Kebi
Aloysius	NLTK
Olivia	NLTK
Hilal	Kebi
Koller	NLTK
Sibylla	NLTK
Simon	NLTK
Gook	NLTK
Isabella	NLTK
Mentari	Kebi
Jauhari	Kebi
Rangga	Kebi
Aimee	NLTK
Abas	NLTK
Symphony	NLTK
Vila	Kebi
Rahayu	Kebi
Clare	NLTK
Gordon	NLTK
Lat	Kebi
Rhodes	NLTK
Gunnar	NLTK
Amina	Kebi
Luigi	NLTK
Sam	NLTK
Woof	NLTK
A.	Satu kata bertitik
Gepeng	Kebi
Zone	Kebi
Hughes	NLTK
Paisley	NLTK
Burman	NLTK
Awi	Kebi
Cornish	NLTK
Sergio	NLTK
Butch	NLTK
Counting	NLTK
Dido	NLTK
EBS	Huruf Besar Semua
Dane	NLTK
Izzard	NLTK
Yati	NLTK
Bond	NLTK
Permana	Kebi
Berlian	Kebi
Rafi	Kebi
Corinne	NLTK
Relativisme	Kebi
Senate	NLTK
Freeman	NLTK
Addy	NLTK
Marcia	NLTK
Jacob	NLTK
Mien	NLTK
MoJo	NLTK
Kai	NLTK
Tina	NLTK
Sin	Kebi
Hurt	NLTK
Shane	NLTK
Solomon	NLTK
Laurel	NLTK
TTS	Huruf Besar Semua
Lien	NLTK
Paquet	NLTK
La	Kebi
Bibit	Kebi
Samad	Kebi
Field	NLTK
Ferrara	NLTK
Clifford	NLTK
Angus	Kebi
Wade	NLTK
Star	NLTK
Ting	Kebi
Kahar	Kebi
Brawn	NLTK
Basil	Kebi
Salomon	NLTK
China	NLTK
Jeremias	NLTK
Moss	NLTK
Iba	Kebi
Bodo	NLTK
Albrecht	NLTK
Cheshire	NLTK
Furlan	NLTK
Stiller	NLTK
Booker	NLTK
Craig	NLTK
Tuan	Kebi
Dick	NLTK
Ammi	Kebi
Selah	NLTK
Raden	Kebi
Shah	NLTK
Caecilia	NLTK
Albert	NLTK
Handler	NLTK
Brock	NLTK
N.W.A.	Satu kata bertitik
Budi	Kebi
Hiro	NLTK
Ansari	Kebi
Heer	NLTK
Ara	Kebi
Stich	NLTK
D.I.	Satu kata bertitik
Pace	Kebi
De	Kebi
Albright	NLTK
Marsh	NLTK
HIM	NLTK
Vincenzo	NLTK
Tree	NLTK
Alphonse	NLTK
Stradivari	NLTK
Spencer	NLTK
Megan	Kebi
Ira	Kebi
A.Tee	Satu kata bertitik
Bram	NLTK
Brandon	NLTK
Honda	NLTK
Imam	Kebi
OAG	Huruf Besar Semua
Ros	Kebi
Yasmin	Kebi
Horn	NLTK
Setiawan	Kebi
Neville	NLTK
New	NLTK
Son	NLTK
Ronni	NLTK
James	NLTK
Arend	NLTK
Frost	NLTK
Andre	NLTK
Rami	Kebi
D.	Satu kata bertitik
Jones	NLTK
Robert	NLTK
Ambrose	NLTK
Sleep	NLTK
Read	NLTK
Mustika	Kebi
Amien	Kebi
Babcock	NLTK
Kick	NLTK
Stain	NLTK
Bi	Kebi
Speer	NLTK
Wedel	Kebi
Thuan	NLTK
E.G.	Satu kata bertitik
Spall	NLTK
Lev	NLTK
Ora	NLTK
Sato	Kebi
Barrett	NLTK
Tabah	Kebi
Kris	NLTK
Maki	Kebi
Suci	Kebi
Run	NLTK
Arctic	NLTK
Mol	Kebi
Bagong	Kebi
Oliphant	NLTK
Garda	Kebi
Jason	NLTK
Panda	NLTK
Oka	NLTK
Batik	Kebi
Lai	Kebi
Amril	Kebi
Doll	NLTK
Apple	NLTK
Nikolai	NLTK
Tommy	NLTK
Roland	NLTK
Alam	Kebi
Elsa	NLTK
Winona	NLTK
Brandy	NLTK
Coda	NLTK
Dian	Kebi
Saidi	Kebi
Ilir	Kebi
Jerome	NLTK
Gilbert	NLTK
Paul	Kebi
Plus	Kebi
Precious	NLTK
Dickens	NLTK
Mouse	NLTK
Nigel	NLTK
Bradley	NLTK
Roma	Kebi
Dao	NLTK
Novel	Kebi
Racun	Kebi
Archer	NLTK
Riva	NLTK
Ada	Kebi
Percy	NLTK
Hammerer	NLTK
Aruan	Kebi
Then	NLTK
Serra	NLTK
Ha	Kebi
Philharmonic	NLTK
T	NLTK
Hafiz	Kebi
Cucuk	Kebi
Rancid	NLTK
Bob	NLTK
Gates	Keulang
Gatot	Kebi
Top	Kebi
April	NLTK
Maire	NLTK
Harmony	NLTK
Udo	Kebi
Enow	NLTK
Joss	NLTK
TH.	Satu kata bertitik
Kiat	Kebi
Wells	Keulang
Raul	NLTK
Beast	NLTK
Indra	Kebi
Genevois	NLTK
Matthieu	NLTK
Infinite	NLTK
Reina	NLTK
Jara	Kebi
Dias	Kebi
Gu	Kebi
Wea	NLTK
Smalling	NLTK
Tedder	NLTK
Iron	NLTK
Streep	NLTK
yang	Kebi
Dolly	NLTK
Sutan	Kebi
Bangun	Kebi
Izumi	NLTK
Maka	Kebi
Stanley	NLTK
Hood	NLTK
