Amara	NLTK
Golden	NLTK
Pullman	NLTK
Lydia	NLTK
Karim	Kebi
Bianca	NLTK
Nathaniel	NLTK
Sabah	Kebi
Rie	NLTK
Zan	Kebi
Crew	NLTK
Fakih	Kebi
Pereira	NLTK
Just	NLTK
Bakar	Kebi
Pussy	NLTK
Cindai	Kebi
Wes	NLTK
Joss	NLTK
Sumitro	NLTK
Sultan	Kebi
Aline	NLTK
Epik	Kebi
Mang	Kebi
Criss	NLTK
M.I.L.K	Satu kata bertitik
Princess	NLTK
Dayang	Kebi
Brown	NLTK
Re	Kebi
Kinsman	NLTK
Asa	Kebi
Freya	NLTK
Ram	Kebi
Cancer	NLTK
Arenas	Lemmatization di nltk
Fare	NLTK
JJ	Huruf Besar Semua
H.G.	Satu kata bertitik
Fico	NLTK
Alejandro	NLTK
Enteng	Kebi
Lean	NLTK
Tack	NLTK
Cynthia	NLTK
Laurent	NLTK
Reuben	NLTK
Dae	NLTK
CL	Huruf Besar Semua
Kral	NLTK
Orson	NLTK
Crane	NLTK
Saki	Kebi
Jim	Kebi
Cuesta	NLTK
Hung	NLTK
Cleopatra	NLTK
Rantau	Kebi
Within	NLTK
Lucretia	NLTK
Jane	NLTK
River	NLTK
Dieter	NLTK
Eva	NLTK
Motte	NLTK
Antonio	NLTK
Madeline	NLTK
Trillo	NLTK
Takdir	Kebi
Florian	NLTK
Map	Kebi
Wetter	NLTK
Laet	NLTK
Roberta	NLTK
Service	NLTK
Gagap	Kebi
Matt	NLTK
Augustus	NLTK
Deru	Kebi
Kadir	Kebi
Samir	Kebi
Saa	NLTK
Awang	Kebi
Stipe	NLTK
Garret	NLTK
Mika	Kebi
Lisa	NLTK
International	NLTK
Thomas	NLTK
Mara	Kebi
Patriark	Kebi
King	NLTK
Hannibal	NLTK
Joel	NLTK
Iras	Kebi
B.	Satu kata bertitik
Kaisar	Kebi
Salam	Kebi
Fana	Kebi
Christophe	NLTK
Marina	NLTK
Vell	NLTK
Teka	Kebi
Diva	NLTK
Antik	Kebi
Moos	Lemmatization di nltk
Nada	Kebi
S.	Satu kata bertitik
Teologi	Kebi
Yogi	Kebi
Sabrina	NLTK
Hurst	NLTK
Bong	Kebi
Gilbert	NLTK
Belo	Kebi
Wass	Lemmatization di nltk
Hening	Kebi
Five	NLTK
Aris	Kebi
Seth	NLTK
Merlin	NLTK
Haris	Kebi
Sylvan	NLTK
Peres	Kebi
Barry	NLTK
Glenn	NLTK
Wonder	NLTK
Murray	NLTK
Ernie	NLTK
Clifford	NLTK
Alim	Kebi
Mailman	NLTK
Degan	Kebi
Gaskins	NLTK
Reiner	NLTK
Andrea	NLTK
Salim	Kebi
Sebai	Kebi
E.A.	Satu kata bertitik
Josh	NLTK
Badawi	NLTK
Ading	Kebi
Victoria	NLTK
di	Kebi
Reeve	NLTK
H.O.T	Satu kata bertitik
Toon	NLTK
Pena	Kebi
Shoji	NLTK
Sevenfold	NLTK
Nil	NLTK
Kaku	Kebi
Chinese	NLTK
G.J.	Satu kata bertitik
Anja	Kebi
Cantor	NLTK
Luluk	Kebi
Sau	Kebi
Laine	NLTK
Dead	NLTK
III	Romawi
Daze	NLTK
Vaughn	NLTK
Awi	Kebi
Vindex	NLTK
Wiseman	NLTK
Rebel	NLTK
Pure	Kebi
Soul	NLTK
KISS	NLTK
Musa	NLTK
Giring	Kebi
Ary	NLTK
Boros	Kebi
Leo	Kebi
Ludwig	NLTK
Beast	NLTK
Sufi	Kebi
Cinta	Kebi
Arctic	NLTK
Marine	Kebi
Geng	Kebi
KH.	Satu kata bertitik
Sylvester	NLTK
Asri	Kebi
Jug	NLTK
Dooley	NLTK
Daman	Kebi
Mano	NLTK
Saga	Kebi
Tyler	NLTK
Reina	NLTK
Walter	NLTK
Isaac	NLTK
Opera	Kebi
Weber	NLTK
Roman	Kebi
Shirley	NLTK
Innocent	NLTK
Dolls	Lemmatization di nltk
sang	Kebi
Jesus	NLTK
Dell	NLTK
Kirana	Kebi
Nala	Kebi
Negara	Kebi
Terry	NLTK
Gama	Kebi
Ingram	NLTK
Juliana	NLTK
Francisca	NLTK
Luis	NLTK
Shan	NLTK
Stradivari	NLTK
Paddy	NLTK
Sersan	Kebi
Roy	NLTK
Bates	Lemmatization di nltk
Cartier	NLTK
Kopral	Kebi
Punk	Kebi
Edward	NLTK
Kubin	Kebi
Sawyer	NLTK
Mecca	NLTK
Countess	NLTK
B	NLTK
Jay	NLTK
Foray	NLTK
Doyle	NLTK
Brooke	NLTK
Kangen	Kebi
Shun	NLTK
Penta	NLTK
Rita	NLTK
Akmal	Kebi
Donna	NLTK
Antonella	NLTK
Lat	Kebi
Marc	NLTK
Polen	Kebi
Tipe	Kebi
Barton	NLTK
Dye	NLTK
Muno	Kebi
Lago	Kebi
Cavendish	NLTK
Sana	Kebi
Winehouse	NLTK
Michel	NLTK
Arrowsmith	NLTK
Room	NLTK
Lancaster	NLTK
Oli	Kebi
Milestone	NLTK
Sidik	Kebi
Snoop	NLTK
Hough	NLTK
D.	Satu kata bertitik
Graham	NLTK
Rabin	NLTK
Gilles	NLTK
Susi	NLTK
Kiley	NLTK
Lax	NLTK
Abigail	NLTK
Spears	Lemmatization di nltk
Katie	NLTK
Prudence	NLTK
Khir	NLTK
Theron	NLTK
Goodman	NLTK
Harmon	NLTK
Air	Kebi
Aras	Kebi
Irish	NLTK
Agger	NLTK
Edo	NLTK
CN	Huruf Besar Semua
Ita	NLTK
Kristin	NLTK
Antara	Kebi
XV	Huruf Besar Semua
Izzard	NLTK
Laurel	NLTK
Wirawan	Kebi
Azamat	Kebi
Yuda	Kebi
Capel	NLTK
Gendut	Kebi
Flores	NLTK
Viola	Kebi
Dunlop	NLTK
Novo	NLTK
Rancid	NLTK
Maud	NLTK
Mesa	NLTK
Amour	NLTK
Manul	NLTK
Mayang	Kebi
Juang	Kebi
Liz	NLTK
Rob	NLTK
RS	Huruf Besar Semua
Sabino	NLTK
Sivan	NLTK
Turner	NLTK
Falak	Kebi
Raphael	NLTK
Mudi	Kebi
Chamberlain	NLTK
Alois	NLTK
Main	Kebi
Sigi	Kebi
Aria	Kebi
Joy	NLTK
Howard	NLTK
Ran	NLTK
Topi	Kebi
Lord	NLTK
Kayo	NLTK
Susanna	NLTK
OAG	Huruf Besar Semua
Ananta	NLTK
Byron	NLTK
Will	NLTK
Pangeran	Kebi
Hardy	NLTK
Harris	NLTK
Pas	Kebi
Chad	NLTK
Smith	NLTK
Maro	Kebi
Vince	NLTK
Z.	Satu kata bertitik
Canals	Lemmatization di nltk
Erika	NLTK
Friends	Lemmatization di nltk
Goo	NLTK
Kus	Kebi
Carver	NLTK
Rocker	NLTK
Pato	NLTK
Timi	Kebi
Perin	Kebi
Stephen	NLTK
Hausen	NLTK
Luce	NLTK
Biz	NLTK
Rose	NLTK
O	NLTK
Ho	NLTK
DeMerit	NLTK
Landes	Lemmatization di nltk
Shin	NLTK
Tari	Kebi
Sanders	NLTK
Beg	NLTK
Porcupine	NLTK
Noda	Kebi
Maskara	Kebi
Buck	NLTK
Randall	NLTK
Killer	NLTK
Forest	NLTK
Tracey	NLTK
Mel	Kebi
Tang	Kebi
Sakti	Kebi
Vista	Kebi
Rip	NLTK
Hwa	NLTK
Peters	Lemmatization di nltk
Shorter	NLTK
Merah	Kebi
Yew	NLTK
Withe	NLTK
Nelson	NLTK
Oren	Kebi
Tunas	Kebi
Immanuel	NLTK
Leontin	Kebi
Sylva	NLTK
Libby	NLTK
Maksim	Kebi
Rolf	NLTK
Kemp	NLTK
Butane	NLTK
Iba	Kebi
Amy	NLTK
Dalton	NLTK
Raden	Kebi
Noah	NLTK
Bale	NLTK
Suu	NLTK
in	Kebi
Bambang	Kebi
Crimson	NLTK
Yasmin	Kebi
Zeus	NLTK
Sadin	Kebi
Bobby	NLTK
Vena	Kebi
Project.R	Satu kata bertitik
Nick	NLTK
Stich	NLTK
Werner	NLTK
Kathryn	NLTK
Taylor	NLTK
R	NLTK
Oswald	NLTK
Gook	NLTK
Samsons	Lemmatization di nltk
Jackman	NLTK
Seko	Kebi
Camel	NLTK
Romain	NLTK
RM.	Satu kata bertitik
Dying	NLTK
Nelly	NLTK
Stewart	NLTK
Eden	NLTK
TVXQ	Huruf Besar Semua
Tofu	NLTK
Malevolent	NLTK
Woodruff	NLTK
Stella	NLTK
Suda	Kebi
Bess	NLTK
Zac	NLTK
E.G.	Satu kata bertitik
Gori	Kebi
Jonah	NLTK
Abraham	NLTK
Buster	NLTK
Tatty	NLTK
ZARD	Huruf Besar Semua
Gumbira	Kebi
Pertiwi	Kebi
Gable	NLTK
Luke	NLTK
Summers	Lemmatization di nltk
Damara	NLTK
Peel	NLTK
Maire	NLTK
Cone	NLTK
Arroyo	NLTK
Josephine	NLTK
Vira	NLTK
Given	NLTK
Goran	NLTK
Ambrose	NLTK
Palermo	NLTK
Bose	NLTK
Ahmed	NLTK
and	NLTK
Obi	Kebi
Jacobus	NLTK
Mick	NLTK
Claudio	NLTK
Syarif	Kebi
Riot	NLTK
Dylan	NLTK
Putu	Kebi
Hermes	NLTK
Gena	Kebi
Jaja	Kebi
Said	Kebi
Mahesh	NLTK
Eliot	NLTK
Ruby	NLTK
Briggs	NLTK
Hun	Kebi
Tasrif	Kebi
Maria	Kebi
Amoroso	NLTK
Brunet	NLTK
Gita	Kebi
Hill	NLTK
Florent	NLTK
Daniel	NLTK
Billy	NLTK
Banana	NLTK
Matthew	NLTK
Juri	Kebi
Mercury	NLTK
Dias	Kebi
Boer	NLTK
Karel	NLTK
Addy	NLTK
Mack	NLTK
Monica	NLTK
Crackdown	NLTK
Jules	NLTK
Roberto	NLTK
Giuseppe	NLTK
Archer	NLTK
School	NLTK
XII	Romawi
Georgie	NLTK
Hop	Kebi
Karma	Kebi
Adem	Kebi
Julio	NLTK
Riva	NLTK
Nu	Kebi
Glen	NLTK
Nazir	Kebi
Electra	NLTK
Gates	Lemmatization di nltk
Juvenal	NLTK
Holiday	NLTK
Baria	NLTK
Ji	Kebi
Planes	Lemmatization di nltk
Michelle	NLTK
St.	Satu kata bertitik
Guram	Kebi
Cast	NLTK
Tirta	Kebi
Silvia	NLTK
Marvin	NLTK
Trio	Kebi
Counting	NLTK
Philip	NLTK
Tag	NLTK
Mat	Kebi
Irma	NLTK
Once	Kebi
REO	Huruf Besar Semua
Fay	NLTK
Lorenzo	NLTK
Geoffrey	NLTK
Frog	NLTK
E.	Satu kata bertitik
Wright	NLTK
Alfonso	NLTK
Halo	Kebi
Patria	NLTK
Madame	NLTK
Suid	NLTK
Christine	NLTK
Vai	NLTK
Born	NLTK
Situ	Kebi
Sha	NLTK
Meriam	Kebi
Frances	NLTK
G.A.	Satu kata bertitik
Wage	Kebi
Cindy	NLTK
Jos	NLTK
Dinar	Kebi
Walters	Lemmatization di nltk
YMCK	Huruf Besar Semua
Lucius	NLTK
Ivy	NLTK
Korban	Kebi
Brokoli	Kebi
Moral	Kebi
Emma	NLTK
Genevois	NLTK
Aaron	NLTK
May	NLTK
Dada	Kebi
Eddies	Lemmatization di nltk
Walker	NLTK
Joanne	NLTK
Eross	Lemmatization di nltk
Plus	Kebi
Francois	NLTK
Mori	Kebi
Wu	NLTK
Timor	NLTK
Rangga	Kebi
Dia	Kebi
Genevieve	NLTK
Card	NLTK
Alba	NLTK
Randa	Kebi
Trivium	NLTK
Olivier	NLTK
Palfrey	NLTK
Nurmala	Kebi
Kit	Kebi
Cate	NLTK
Puspita	Kebi
Holden	NLTK
Winston	NLTK
Latif	Kebi
Carrick	NLTK
Stone	NLTK
Bemba	NLTK
Saleh	Kebi
Davy	NLTK
Anggara	Kebi
Crocker	NLTK
Mirza	NLTK
Belle	NLTK
Drew	NLTK
Rosetta	NLTK
Candy	NLTK
Doe	NLTK
Gabriel	NLTK
Gentile	NLTK
Tri	NLTK
M.T.	Satu kata bertitik
Inch	NLTK
Karya	Kebi
Harden	NLTK
Elisabeth	NLTK
Darin	NLTK
Maureen	NLTK
Kee	NLTK
Collin	NLTK
Panglima	Kebi
Orkes	Kebi
Sena	Kebi
Kawan	Kebi
Guz	NLTK
Vega	NLTK
Cabanas	Lemmatization di nltk
Toma	NLTK
Angga	Kebi
Henry	Kebi
Fleet	NLTK
Amat	Kebi
Turut	Kebi
Than	NLTK
Tim	Kebi
A.R.	Satu kata bertitik
Volts	Lemmatization di nltk
Isa	Kebi
tiga	Kebi
Perch	NLTK
Holla	NLTK
Log	Kebi
Arend	NLTK
Lee	NLTK
ABBA	Huruf Besar Semua
Zeppelin	NLTK
Ganjar	Kebi
Lew	NLTK
Angula	NLTK
Zamzam	Kebi
Spray	NLTK
Tiffany	NLTK
Rudd	NLTK
Bobo	NLTK
Andika	Kebi
Booth	NLTK
Singh	NLTK
Mina	Kebi
Enes	Kebi
Hitchings	Lemmatization di nltk
Aulia	Kebi
Bertrand	NLTK
Jonas	NLTK
Moore	NLTK
Vera	NLTK
Agil	Kebi
Lyndon	NLTK
Peppers	Lemmatization di nltk
Silas	NLTK
Brendan	NLTK
Klasik	Kebi
Knight	NLTK
Eddy	NLTK
Cow	NLTK
Count	NLTK
Cahaya	Kebi
Lawless	NLTK
al	Kebi
Taft	NLTK
Ki	Kebi
BM.	Satu kata bertitik
Vicious	NLTK
Aziz	Kebi
Mats	NLTK
Hip	Kebi
Tapping	NLTK
mileage	NLTK
Graeme	NLTK
Rais	Kebi
Colt	NLTK
Hikmat	Kebi
Heinrich	NLTK
Dadi	Kebi
Wawa	Kebi
P	NLTK
Die	NLTK
Yayi	Kebi
Taslim	Kebi
Gede	Kebi
Looms	Lemmatization di nltk
Celsius	Kebi
Mitt	NLTK
Julie	NLTK
Aloysius	NLTK
Wang	Kebi
Gerald	NLTK
Ross	NLTK
Khalil	Kebi
Stam	NLTK
Karas	Kebi
Varas	Lemmatization di nltk
Carole	NLTK
Ratu	Kebi
Cory	NLTK
Bogart	NLTK
Amber	NLTK
Terrorizer	NLTK
Gusti	Kebi
BoA	NLTK
Sandy	NLTK
I	NLTK
Benward	NLTK
Galt	NLTK
Plant	NLTK
Diane	NLTK
Fifie	NLTK
Ava	NLTK
Min	Kebi
Gamaliel	NLTK
Costa	NLTK
Wilkinson	NLTK
H	NLTK
Bacon	NLTK
Pontus	NLTK
Andre	NLTK
Leak	Kebi
Nash	NLTK
Luna	NLTK
Big	NLTK
Melinda	NLTK
Tess	NLTK
Pinto	NLTK
Ds	Lemmatization di nltk
Felix	NLTK
Wyss	NLTK
Paskah	Kebi
Canaan	NLTK
Nadir	Kebi
Amina	Kebi
Moulin	NLTK
Justin	NLTK
Ephraim	NLTK
Mora	NLTK
Norah	NLTK
Mega	Kebi
Mandra	NLTK
Robles	Lemmatization di nltk
Sie	NLTK
Fathers	Lemmatization di nltk
Clerk	NLTK
Radu	Kebi
Yao	NLTK
Page	NLTK
R.E.	Satu kata bertitik
Selly	NLTK
Heer	NLTK
Erasure	NLTK
Burak	Kebi
APT	NLTK
Savage	NLTK
Yuan	NLTK
Feri	Kebi
Minimal	Kebi
Gene	NLTK
On	Kebi
Iswara	NLTK
Crofts	Lemmatization di nltk
E.C.	Satu kata bertitik
Flack	NLTK
Francisco	NLTK
Barber	Kebi
DJ	Huruf Besar Semua
Jozy	NLTK
Muslim	Kebi
Bonjol	Kebi
Hetman	NLTK
Reynold	NLTK
Bani	Kebi
Perdana	Kebi
Mae	NLTK
Shawn	NLTK
Freddie	NLTK
Baran	Kebi
B.A.P	Satu kata bertitik
Hoon	NLTK
Cristina	NLTK
Waits	Lemmatization di nltk
X	Kebi
Relativisme	Kebi
Blues	NLTK
Mashal	NLTK
Leno	NLTK
Naik	Kebi
Reiter	NLTK
Rio	NLTK
Sambi	Kebi
Petit	NLTK
Java	NLTK
Walt	NLTK
Woof	NLTK
Sock	NLTK
Platt	NLTK
Ward	NLTK
Manda	Kebi
Ruak	Kebi
Arango	NLTK
Pee	NLTK
Tilda	NLTK
Kader	Kebi
Wayne	NLTK
Ezra	NLTK
Aqua	NLTK
Best	NLTK
Block	NLTK
Rama	Kebi
Shen	NLTK
Sutan	Kebi
Derek	Kebi
Drake	NLTK
S.K.	Satu kata bertitik
Hin	NLTK
Frison	NLTK
Yon	NLTK
Apam	Kebi
Ae	NLTK
Oka	NLTK
Bungsu	Kebi
Matan	Kebi
Belay	NLTK
Hummel	NLTK
Gray	NLTK
Safari	Kebi
Ariana	NLTK
Durant	NLTK
Terri	NLTK
Basa	Kebi
Juhi	Kebi
S.E.S.	Satu kata bertitik
Clough	NLTK
Eru	Kebi
Quicksilver	NLTK
Mouly	NLTK
Tasa	Kebi
Tiar	NLTK
A	NLTK
Marty	NLTK
Donnie	NLTK
Hind	NLTK
Hildebrand	NLTK
Terrence	NLTK
Hollo	NLTK
Bay	NLTK
Very	NLTK
Nicholas	NLTK
Eric	NLTK
Georgia	NLTK
Permana	Kebi
Gordon	NLTK
IV	Romawi
Spence	NLTK
Fernando	NLTK
Ethan	NLTK
Glory	NLTK
Luther	NLTK
Cook	NLTK
Matsu	NLTK
Weatherly	NLTK
MC	Huruf Besar Semua
Daler	NLTK
Dill	NLTK
Becker	NLTK
Horner	NLTK
EBS	Huruf Besar Semua
Polo	Kebi
Kasai	Kebi
Heck	NLTK
Veranda	NLTK
Kasih	Kebi
Jed	NLTK
Erik	Kebi
Derry	NLTK
Roh	Kebi
Taufan	Kebi
Darius	NLTK
Tanda	Kebi
Kelana	Kebi
Bella	NLTK
Gigi	Kebi
Jackson	NLTK
Jaya	Kebi
Ros	Kebi
Chena	NLTK
Bibit	Kebi
Dalem	Kebi
Fritz	NLTK
Pipes	Lemmatization di nltk
Grot	NLTK
Ragnar	NLTK
Bayal	NLTK
Hurt	NLTK
Car	NLTK
Iman	Kebi
Aso	Kebi
Norman	NLTK
Graff	NLTK
Adriana	NLTK
Calmy	NLTK
Joshua	NLTK
Rawa	Kebi
Atomic	NLTK
Gatra	Kebi
Arena	Kebi
Balan	Kebi
Bayu	Kebi
Kembar	Kebi
Mambo	Kebi
Brooks	Lemmatization di nltk
Rami	Kebi
Barrett	NLTK
Gilang	Kebi
Hulk	NLTK
Daniele	NLTK
Della	NLTK
Bing	NLTK
Rajab	Kebi
Rukiah	Kebi
Hetty	NLTK
Tahan	Kebi
Barrios	Lemmatization di nltk
Tran	NLTK
Port	NLTK
Andung	Kebi
Mandi	Kebi
Xi	NLTK
Ilia	NLTK
Himawan	NLTK
Eveline	NLTK
Alicia	NLTK
Duncan	NLTK
SMAP	Huruf Besar Semua
Martens	Lemmatization di nltk
Hilal	Kebi
H.	Satu kata bertitik
Alf	Kebi
Grosso	NLTK
Fitri	Kebi
Gol	Kebi
Ivan	NLTK
Maiden	NLTK
Revolusi	Kebi
V	Kebi
Conor	NLTK
Sud	NLTK
Racer	NLTK
Sompong	Kebi
RJ	Huruf Besar Semua
Timur	Kebi
April	Kebi
Cipta	Kebi
Pink	NLTK
Dolores	NLTK
Manfred	NLTK
milady	NLTK
Robbin	NLTK
German	NLTK
Zahid	Kebi
Mason	Kebi
Sammer	NLTK
Fully	NLTK
Testone	NLTK
Ju	NLTK
Koch	NLTK
Benjamin	NLTK
Daming	Lemmatization di nltk
Dunia	Kebi
Swift	NLTK
Amini	NLTK
Up	NLTK
Sharon	NLTK
Carsten	NLTK
Fu	NLTK
Schneider	NLTK
Brunt	NLTK
Marshal	NLTK
Boa	NLTK
Isra	Kebi
Gong	Kebi
Slovak	NLTK
Sienna	NLTK
Lake	NLTK
Bailey	NLTK
Romero	NLTK
William	NLTK
Nini	Kebi
Albrecht	NLTK
Weaving	NLTK
Keys	Lemmatization di nltk
Bangles	Lemmatization di nltk
Steer	NLTK
Ming	NLTK
Matthias	NLTK
Amien	Kebi
B.Z.	Satu kata bertitik
Mahesa	Kebi
Ayunda	Kebi
Snow	NLTK
Eduardo	NLTK
Kate	Kebi
Run	NLTK
Carcass	NLTK
Smalling	NLTK
Coast	NLTK
Gilas	Kebi
Carpenter	NLTK
Verre	NLTK
Saidi	Kebi
Hayward	NLTK
Nepa	NLTK
Item	Kebi
MahaDewa	Kebi
Corinne	NLTK
Griffin	NLTK
Daun	Kebi
Sylvia	NLTK
Pier	NLTK
Hay	NLTK
Vall	NLTK
Carl	NLTK
Huh	Kebi
Fowler	NLTK
Alexander	NLTK
Temple	NLTK
Filippo	NLTK
Niall	NLTK
Aja	Kebi
Pander	NLTK
Tahir	Kebi
Carrizo	NLTK
With	NLTK
Soter	NLTK
Nako	NLTK
Chance	NLTK
Giovanni	NLTK
Dusky	NLTK
Erwin	NLTK
Gideon	NLTK
Irene	NLTK
Tin	Kebi
Idola	Kebi
Uli	Kebi
Nils	NLTK
Savitri	NLTK
SPYAIR	Huruf Besar Semua
Key	NLTK
Mikael	NLTK
Fatima	NLTK
Vilhelm	NLTK
Malai	Kebi
Demy	NLTK
TTS	Huruf Besar Semua
Julia	NLTK
W-inds.	Satu kata bertitik
Ibing	Kebi
Infinite	NLTK
Pranata	Kebi
Arm	NLTK
Tina	NLTK
Justina	NLTK
Johann	NLTK
Koda	Kebi
Fletcher	NLTK
Salva	NLTK
Diesel	Kebi
Burgess	NLTK
Baltimore	NLTK
Archie	NLTK
Davies	Lemmatization di nltk
Kali	Kebi
Cage	NLTK
Barnabas	NLTK
Per	Kebi
Lotte	NLTK
Indy	NLTK
Dave	NLTK
Axel	NLTK
Club	NLTK
Branch	NLTK
Earring	NLTK
Jalal	Kebi
Domba	Kebi
Franco	NLTK
Benedict	NLTK
Hain	NLTK
Yo	NLTK
Fendy	NLTK
Sergei	NLTK
Woon	NLTK
Pen	Kebi
Sojourner	NLTK
Udi	Kebi
Holm	NLTK
Dalia	Kebi
Johan	Kebi
Choky	NLTK
Nate	NLTK
Baxter	NLTK
Josip	NLTK
Puspa	Kebi
ID	Kebi
Nellie	NLTK
Sali	Kebi
Archimedes	NLTK
Kan	Kebi
Jung	Kebi
Meg	NLTK
Neves	Lemmatization di nltk
Cox	NLTK
Arthur	NLTK
Ati	Kebi
Sebastian	NLTK
Chang	NLTK
Melik	Kebi
Chaka	NLTK
Ariel	NLTK
Static	NLTK
Elihu	NLTK
Kay	NLTK
Martial	NLTK
Leopold	NLTK
Ameen	NLTK
Lynch	NLTK
Jem	Kebi
Dev	NLTK
Alonso	NLTK
Bening	Kebi
Ralph	NLTK
Kempot	Kebi
Horn	NLTK
Yu	Kebi
Russel	NLTK
Eugene	NLTK
Carlin	NLTK
Oleh	Kebi
Monk	NLTK
Dustin	NLTK
Heller	NLTK
Llama	NLTK
Khar	NLTK
Bomber	Kebi
N	Kebi
Sawyers	Lemmatization di nltk
Freeman	NLTK
Johanna	NLTK
XO	Huruf Besar Semua
Thema	NLTK
Kirk	NLTK
Lima	Kebi
Girls	Lemmatization di nltk
Janker	NLTK
Kane	Kebi
Crosby	NLTK
Tubman	NLTK
New	NLTK
America	NLTK
Mestika	Kebi
Yan	NLTK
Suzy	NLTK
Maka	Kebi
Oki	NLTK
Brownback	NLTK
Adrenaline	NLTK
Rudy	NLTK
As	Kebi
Sami	Kebi
Gladys	NLTK
Racun	Kebi
Carr	NLTK
Muse	NLTK
John	NLTK
Cat	Kebi
Gepeng	Kebi
Makos	Lemmatization di nltk
Tarzan	Kebi
Batik	Kebi
Lestari	Kebi
Linden	NLTK
Asha	NLTK
Tango	Kebi
Breasted	NLTK
Lay	NLTK
Marshall	NLTK
Mauri	NLTK
Sukma	Kebi
Celia	NLTK
Aksa	Kebi
Ora	NLTK
Kolo	NLTK
Lamas	Lemmatization di nltk
Dike	NLTK
Anna	NLTK
Janet	NLTK
Jakob	NLTK
Piet	NLTK
Kamal	Kebi
Kati	Kebi
Konan	Kebi
Strange	NLTK
Yen	NLTK
Harold	NLTK
Mann	NLTK
Kitten	NLTK
Bur	Kebi
Mahmud	Kebi
Cooper	NLTK
Palar	Kebi
Claudia	NLTK
Quagmire	NLTK
Groove	NLTK
Potter	NLTK
Phoenix	NLTK
Patek	Kebi
Ness	NLTK
Archibald	NLTK
Virginia	Kebi
Rusa	Kebi
ANM	Huruf Besar Semua
Frazer	NLTK
Mien	NLTK
Dani	NLTK
GT	Huruf Besar Semua
Mistry	NLTK
Harry	NLTK
Meng	NLTK
Gun	Kebi
F.T.	Satu kata bertitik
Lawalata	Kebi
Misionaris	Kebi
la	Kebi
Tam	Kebi
Field	NLTK
Andam	Kebi
Papa	Kebi
Randal	NLTK
Niels	NLTK
Levi	NLTK
Pascal	NLTK
S	Kebi
Malcolm	NLTK
Gnarls	Lemmatization di nltk
Bertha	NLTK
Rimes	Lemmatization di nltk
Benny	NLTK
Sid	NLTK
Halim	Kebi
Luc	NLTK
Dwight	NLTK
Hot	Kebi
Wainwright	NLTK
Marsh	NLTK
Ujud	Kebi
Nuraga	Kebi
Koko	NLTK
P.V.	Satu kata bertitik
House	NLTK
Biasa	Kebi
Komeng	Kebi
Tukul	Kebi
Scotty	NLTK
Helmes	Lemmatization di nltk
Andi	NLTK
Rives	Lemmatization di nltk
Tal	Kebi
Ketchup	NLTK
Joon	NLTK
Loach	NLTK
Guti	NLTK
J.K.	Satu kata bertitik
Sa	Kebi
Belinda	NLTK
T	NLTK
Coco	NLTK
Godwin	NLTK
Wallach	NLTK
Rida	Kebi
Burnet	NLTK
Valentin	Kebi
Manai	Kebi
Priscilla	NLTK
Travis	NLTK
Babys	Lemmatization di nltk
Pearl	NLTK
Hafiz	Kebi
Top	Kebi
Pitter	NLTK
Ace	NLTK
Netty	NLTK
Babu	Kebi
JAM	Kebi
Paradise	NLTK
Infante	NLTK
Theobald	NLTK
Wilders	Lemmatization di nltk
Tera	Kebi
Tuanku	Kebi
Wahid	Kebi
Bunton	NLTK
Ray	NLTK
Aura	Kebi
Real	Kebi
Miles	NLTK
January	NLTK
Kwan	NLTK
Hood	NLTK
Juno	NLTK
Doughty	NLTK
Isidore	NLTK
Antar	Kebi
Dubs	NLTK
Mos	Lemmatization di nltk
Acker	NLTK
Restu	Kebi
Mubarak	Kebi
Abdu	Kebi
Zeta	Kebi
Phantom	NLTK
Fall	NLTK
Blair	NLTK
Raya	Kebi
Bumi	Kebi
Kristian	NLTK
J.G.	Satu kata bertitik
Bara	Kebi
Aimee	NLTK
Ito	NLTK
Loco	NLTK
Faust	NLTK
Ambo	NLTK
Dai	Kebi
Pepe	Kebi
Indah	Kebi
Roma	Kebi
Jared	NLTK
Van	NLTK
Lusk	NLTK
Marek	NLTK
Ezekiel	NLTK
E	Kebi
Albin	NLTK
Green	NLTK
Dickens	NLTK
Lobo	NLTK
Mile	NLTK
Weeks	Lemmatization di nltk
Linda	NLTK
Fei	NLTK
Theo	NLTK
Chen	NLTK
Allen	NLTK
Watts	Lemmatization di nltk
Prabu	Kebi
Butt	NLTK
Kara	Kebi
T.A.T.u.	Satu kata bertitik
Albert	NLTK
Bedene	NLTK
Saint	NLTK
Amine	NLTK
Geoff	NLTK
Radin	Kebi
Maarten	NLTK
Ibnu	Kebi
Rahayu	Kebi
Bolot	Kebi
Hoed	Lemmatization di nltk
Sage	NLTK
Nane	NLTK
Short	NLTK
Um	Kebi
Melissa	NLTK
Muir	NLTK
Tika	Kebi
Naif	Kebi
Serse	Kebi
Sasa	Kebi
Tino	NLTK
Zein	NLTK
Bebe	Kebi
Ku	Kebi
Sulla	NLTK
Brede	NLTK
Don	Kebi
Deep	NLTK
Intan	Kebi
Jari	Kebi
Shelter	NLTK
Raka	Kebi
Po	Kebi
Nia	Kebi
Brood	NLTK
Jacky	NLTK
R.K.	Satu kata bertitik
Two	NLTK
Lala	Kebi
Arias	Lemmatization di nltk
Merman	NLTK
Dimple	NLTK
Cartwright	NLTK
Lambert	Kebi
Oscar	NLTK
Chiefs	Lemmatization di nltk
Kahar	Kebi
Miranda	NLTK
Danny	NLTK
Dena	Kebi
Puan	Kebi
Stein	NLTK
Tulus	Kebi
Shire	NLTK
Ibra	Kebi
Astrid	NLTK
Patricia	NLTK
Wood	NLTK
Coke	NLTK
Margarita	NLTK
Krishna	NLTK
Maharani	Kebi
Tenacious	NLTK
Rosemary	NLTK
Pussycat	NLTK
Rahmah	Kebi
Frederica	NLTK
Ceper	Kebi
Maurice	NLTK
Lars	Kebi
Pied	NLTK
Craig	NLTK
Ellen	NLTK
Kekal	Kebi
Beatrix	NLTK
Hijau	Kebi
Suwita	Kebi
Creation	NLTK
Morton	NLTK
Charlene	NLTK
Tai	NLTK
Tata	Kebi
Edgar	NLTK
Blunt	NLTK
Markis	Kebi
INXS	Huruf Besar Semua
Parra	NLTK
Fink	NLTK
Bak	Kebi
Monte	NLTK
Machar	NLTK
Heath	NLTK
Hana	Kebi
Tracy	NLTK
Dunst	NLTK
Griffith	NLTK
Mantilla	NLTK
Reeves	Lemmatization di nltk
Nan	Kebi
Lam	Kebi
KM	Huruf Besar Semua
Can	NLTK
Vance	NLTK
Riley	NLTK
Gunther	NLTK
Bartram	NLTK
Read	NLTK
Dong	Kebi
Missy	NLTK
Wolfram	Kebi
Precious	NLTK
Hasan	Kebi
HW	Huruf Besar Semua
Alif	Kebi
Piotr	NLTK
Irena	NLTK
Lama	Kebi
Jan	NLTK
Handler	NLTK
Macan	Kebi
Caroline	NLTK
Moody	NLTK
Dixit	NLTK
Tipper	NLTK
Vidya	NLTK
Marcello	NLTK
Null	NLTK
Tan	Kebi
Underwood	NLTK
Brands	Lemmatization di nltk
Kudus	Kebi
Unity	NLTK
Quo	NLTK
Hamilton	NLTK
Mino	NLTK
Tiara	Kebi
Herling	NLTK
Bert	NLTK
Duo	NLTK
ADA	Kebi
Hall	NLTK
Tandy	NLTK
Cork	NLTK
Leon	NLTK
ZZ	Huruf Besar Semua
Glover	NLTK
Bolling	NLTK
Poe	NLTK
Bender	NLTK
KRU	Kebi
Meles	NLTK
Rodney	NLTK
Pringle	NLTK
Katinka	NLTK
Lohan	NLTK
Elvira	NLTK
Fretes	Lemmatization di nltk
Tamara	NLTK
Tusk	NLTK
Pia	NLTK
Winnie	NLTK
Band	NLTK
Athena	NLTK
Emmanuel	NLTK
Kusti	Kebi
Song	NLTK
Turk	NLTK
Go	NLTK
Anis	Kebi
Dahlia	Kebi
Boy	NLTK
Rafe	Kebi
Springer	NLTK
Plastic	NLTK
Hawking	NLTK
Graves	NLTK
God	NLTK
DMM	Huruf Besar Semua
Rick	NLTK
Ana	Kebi
Chubby	NLTK
Brazil	NLTK
Baptis	Kebi
Yeo	NLTK
Dodo	NLTK
Dangerous	NLTK
Damme	NLTK
Jill	NLTK
Sisi	Kebi
Bright	NLTK
Seamus	NLTK
Maxwell	NLTK
Amir	Kebi
Nuri	Kebi
Early	NLTK
Bodo	NLTK
Presley	NLTK
Bounty	NLTK
Shadows	Lemmatization di nltk
Babel	NLTK
Guido	NLTK
Konstantin	NLTK
Elias	NLTK
Amos	NLTK
Pica	Kebi
Shane	NLTK
Hiren	NLTK
Painter	NLTK
Nik	Kebi
Arifin	Kebi
Jussi	NLTK
Shola	NLTK
Sar	Kebi
Shi	NLTK
Albee	NLTK
Chetty	NLTK
A.	Satu kata bertitik
Sidy	NLTK
Ethel	NLTK
Bagas	Kebi
Lie	NLTK
Kang	Kebi
Golgi	NLTK
Lolo	NLTK
Elliott	NLTK
Paquet	NLTK
Bi	Kebi
Hui	NLTK
Olivia	NLTK
Tji	NLTK
Kardinal	Kebi
Lien	NLTK
W.	Satu kata bertitik
Combs	Lemmatization di nltk
Huckle	NLTK
Clift	NLTK
Bean	NLTK
Judith	NLTK
Oda	NLTK
Fetus	Kebi
Mimi	Kebi
Hubert	NLTK
Jef	NLTK
Batari	Kebi
Minum	Kebi
Zen	Kebi
Ave	NLTK
Joran	Kebi
Rutherford	NLTK
Bradbury	NLTK
Yuki	NLTK
Mursal	Kebi
Tek	Kebi
Melody.	Satu kata bertitik
Tanjung	Kebi
Jelly	NLTK
Tugas	Kebi
Wijaya	Kebi
Sandra	Kebi
Purnama	Kebi
Bahri	Kebi
Hunt	NLTK
Bow	NLTK
Whitehead	NLTK
Price	NLTK
Hidayat	Kebi
Barnard	NLTK
Lightning	NLTK
Metin	NLTK
Muhammad	Kebi
Sen	Kebi
Gafur	Kebi
Hubble	NLTK
Simson	NLTK
Smithies	Lemmatization di nltk
Eutanasia	Kebi
Marko	NLTK
Mahmudi	NLTK
Lincoln	NLTK
Angel	Kebi
Mots	Lemmatization di nltk
Cecilia	NLTK
Gie	NLTK
Marcia	NLTK
Lys	NLTK
Nam	NLTK
Trevor	NLTK
Shoes	Lemmatization di nltk
Arwana	Kebi
Battle	NLTK
Shastri	NLTK
Wahib	Kebi
Palla	NLTK
Juan	NLTK
Forman	Kebi
Angelina	NLTK
V.	Satu kata bertitik
Cucuk	Kebi
Linus	NLTK
Ge	Kebi
Ryder	NLTK
Lana	Kebi
Letitia	NLTK
Parfait	NLTK
Angels	Lemmatization di nltk
Pixie	NLTK
Waterman	NLTK
Serenade	NLTK
Bowo	Kebi
Unveils	Lemmatization di nltk
Tree	NLTK
Gatot	Kebi
Pahala	Kebi
Martel	NLTK
Jo	NLTK
Dina	Kebi
Thalia	NLTK
Murphy	NLTK
Indra	Kebi
Capa	Kebi
Gabe	NLTK
Hanna	NLTK
Dearly	NLTK
wa	Kebi
Kandar	Kebi
Lorraine	NLTK
Kafka	NLTK
Lata	Kebi
Kenan	Kebi
Formica	NLTK
Herbert	NLTK
Boniface	NLTK
Sterling	NLTK
Reese	NLTK
Bawa	Kebi
Barel	Kebi
MahaDewi	Kebi
J	NLTK
Wolf	NLTK
Plaza	Kebi
Ramadan	Kebi
Singer	NLTK
Mini	Kebi
Cannibal	NLTK
Little	NLTK
Ai	Kebi
Wanita	Kebi
Dana	Kebi
Martha	NLTK
Satu	Kebi
Ravin	NLTK
Alphonso	NLTK
Correa	NLTK
Louis	NLTK
Degen	Kebi
Sade	NLTK
Jaqueline	NLTK
Susan	NLTK
Santos	NLTK
Gasser	NLTK
Rima	Kebi
Reddy	NLTK
Garner	NLTK
Hina	Kebi
Speer	NLTK
Kelly	NLTK
Hiro	NLTK
Muda	Kebi
Stevan	NLTK
Clover	NLTK
Poco	NLTK
Kristen	Kebi
Angus	Kebi
Megan	Kebi
Indiana	NLTK
Wulan	Kebi
Tanaka	NLTK
Hank	NLTK
Sundari	Kebi
Slipknot	NLTK
Asma	Kebi
Elsa	NLTK
Abul	Kebi
Widi	Kebi
Christina	NLTK
Gunawan	Kebi
Lucia	NLTK
Anas	NLTK
anugerah	Kebi
Night	NLTK
Anastasia	NLTK
Frizzy	NLTK
Hau	NLTK
Caecilia	NLTK
Carol	NLTK
Adipati	Kebi
Tong	Kebi
Tua	Kebi
Olof	NLTK
Helge	NLTK
Truth	NLTK
Slash	NLTK
Galore	NLTK
Muller	NLTK
Almira	NLTK
Steven	NLTK
Bongo	Kebi
C.	Satu kata bertitik
Jesper	NLTK
Antun	Kebi
Ulysses	NLTK
Roland	NLTK
Jordan	NLTK
Quinton	NLTK
Jacques	NLTK
N.W.A.	Satu kata bertitik
Keng	Kebi
Manny	NLTK
Slade	NLTK
Baron	Kebi
Wim	NLTK
Jeffery	NLTK
Mohammad	NLTK
Stacy	NLTK
Devoured	Lemmatization di nltk
Kumai	Kebi
Taro	NLTK
K.K.	Satu kata bertitik
Kejora	Kebi
TH.	Satu kata bertitik
Pane	NLTK
Vadim	NLTK
Culver	NLTK
Constantine	NLTK
Crom	NLTK
Hein	NLTK
Alya	NLTK
Mike	NLTK
Daphne	NLTK
Park	NLTK
Roosevelt	NLTK
Vengeance	NLTK
Aung	Kebi
Hughes	NLTK
Dale	NLTK
Hanif	Kebi
Clement	NLTK
Bana	NLTK
Merton	NLTK
Roderick	NLTK
Wales	Lemmatization di nltk
Ibo	NLTK
Tate	NLTK
Bridges	Lemmatization di nltk
Parsons	Lemmatization di nltk
Zet	Kebi
Jauhari	Kebi
Gore	NLTK
Wells	Lemmatization di nltk
Christie	NLTK
Saad	NLTK
Rex	NLTK
Boston	NLTK
Cherry	NLTK
Welling	NLTK
Mukti	NLTK
MIQ	Huruf Besar Semua
Bacharach	NLTK
Roda	Kebi
Jasmine	NLTK
Q	NLTK
Sahid	Kebi
Mira	NLTK
Dik	Kebi
Bonnet	NLTK
Bukan	Kebi
Non	Kebi
Began	Lemmatization di nltk
DUARTE	Huruf Besar Semua
Demi	Kebi
Bernard	NLTK
Pretty	NLTK
Calvin	NLTK
Isak	Kebi
Tiffin	NLTK
Kyu	NLTK
Goma	NLTK
Basten	NLTK
Fan	NLTK
Corpse	NLTK
oleh	Kebi
Wise	NLTK
Spelling	NLTK
Margaret	NLTK
Ria	Kebi
Burt	NLTK
Che	NLTK
Arif	Kebi
Sudi	Kebi
Sakai	Kebi
Luka	Kebi
Mol	Kebi
Kaiser	NLTK
Dulles	Lemmatization di nltk
Valentine	NLTK
Sori	Kebi
VI	Romawi
Scott	NLTK
Woody	NLTK
Audio	Kebi
Peter	NLTK
Swank	NLTK
Bang	Kebi
Malaka	Kebi
Jong	NLTK
Gloria	NLTK
Bush	NLTK
Bujang	Kebi
Anggun	Kebi
Lilian	NLTK
Bukit	Kebi
Octave	NLTK
Mob	Kebi
Bahar	Kebi
Bel	Kebi
Guns	Lemmatization di nltk
Pim	NLTK
Yeni	NLTK
Winger	NLTK
Irwin	NLTK
Tanya	Kebi
Rath	NLTK
Chao	NLTK
Tumpal	Kebi
Putri	Kebi
Creed	NLTK
Olla	NLTK
Joni	NLTK
Sumbang	Kebi
Messing	NLTK
Laurin	NLTK
Jero	Kebi
Anang	Kebi
Chico	NLTK
Stop	Kebi
Rice	NLTK
Berg	NLTK
Lins	Lemmatization di nltk
Nazar	Kebi
Durst	NLTK
Citra	Kebi
Heng	Kebi
Teguh	Kebi
Finn	NLTK
Justice	NLTK
Anita	NLTK
L.A.	Satu kata bertitik
Doddy	NLTK
Irvin	NLTK
Bayar	Kebi
Alec	NLTK
Soares	Lemmatization di nltk
Katharine	NLTK
Space	NLTK
Mills	Lemmatization di nltk
Wilder	NLTK
Luri	NLTK
Louisa	NLTK
Umbara	Kebi
Gunter	NLTK
Mary	NLTK
Muluk	Kebi
Lindsay	NLTK
Gregory	NLTK
Ruddy	NLTK
Navy	NLTK
Raja	Kebi
Burgh	NLTK
Sunny	NLTK
Ko	NLTK
Steed	NLTK
Brandy	NLTK
Kodi	Kebi
Merry	NLTK
Hukum	Kebi
Donat	Kebi
te	Kebi
Superman	NLTK
Aku	Kebi
Bebi	Kebi
Tore	NLTK
E.E.	Satu kata bertitik
Kuya	Kebi
Akkad	NLTK
MJ	Huruf Besar Semua
Jimmy	NLTK
Sadie	NLTK
Kembara	Kebi
Ignatius	NLTK
Charlotte	NLTK
Manik	Kebi
Kempes	Kebi
Soldado	NLTK
Napalm	Kebi
Titus	NLTK
Ami	Kebi
KW	Huruf Besar Semua
Damar	Kebi
Lili	Kebi
Nguyen	NLTK
Nathanael	NLTK
Kathleen	NLTK
Generation	NLTK
Lisan	Kebi
Albright	NLTK
Slayer	NLTK
Colback	NLTK
Denis	NLTK
Bandang	Kebi
Rinaldo	NLTK
MOOMIN	Huruf Besar Semua
Evan	NLTK
Buddha	Kebi
Ricky	NLTK
Dalle	NLTK
Addie	NLTK
Willow	NLTK
Rory	NLTK
Syah	Kebi
Palmer	NLTK
Amar	Kebi
Paulin	NLTK
K.N.	Satu kata bertitik
Rana	Kebi
A.S.	Satu kata bertitik
Shandy	NLTK
Moses	NLTK
Jude	NLTK
Ken	Kebi
Cherubin	NLTK
Nails	Lemmatization di nltk
Ong	Kebi
Samak	Kebi
Nizam	NLTK
Yap	NLTK
Busby	NLTK
Pieter	NLTK
Funk	NLTK
Elisha	NLTK
Abbie	NLTK
Timbul	Kebi
Lamela	Kebi
Ahmadi	NLTK
Dal	Kebi
Hagi	NLTK
Devon	NLTK
Bismarck	NLTK
Tyke	NLTK
Ahmet	NLTK
Ca	Kebi
Munsyi	Kebi
Buisson	NLTK
Bunda	Kebi
HIM	NLTK
Zee	NLTK
Dawson	NLTK
Emily	NLTK
Marah	Kebi
Pilar	Kebi
Salmon	Kebi
Sri	Kebi
Veronica	NLTK
Noble	NLTK
Angie	NLTK
Aries	Kebi
Villa	NLTK
Rosa	NLTK
Chevalier	NLTK
Imam	Kebi
Blake	NLTK
Chester	NLTK
Rug	NLTK
Laurence	NLTK
Pope	NLTK
Fryers	Lemmatization di nltk
Lopes	Lemmatization di nltk
Radek	NLTK
Landers	Lemmatization di nltk
Honda	NLTK
Gale	NLTK
Holly	NLTK
North	NLTK
Tung	Kebi
Mona	NLTK
Vela	NLTK
Gani	Kebi
Nara	Kebi
Duda	Kebi
Nova	Kebi
Mursyid	Kebi
Tedder	NLTK
Everett	NLTK
Putut	Kebi
Rollo	NLTK
Emir	Kebi
Cerci	NLTK
Bowie	NLTK
Bracker	NLTK
Henrietta	NLTK
Carlos	NLTK
A.Tee	Satu kata bertitik
Garnet	Kebi
Andrew	NLTK
Dao	NLTK
Nugraha	Kebi
Lo	Kebi
Straits	Lemmatization di nltk
Jeremias	NLTK
Basso	NLTK
Wea	NLTK
Dunne	NLTK
Den	Kebi
Budiman	Kebi
Askar	Kebi
Blanco	NLTK
Tribe	NLTK
EVO	Huruf Besar Semua
Oper	Kebi
Asmara	Kebi
Alex	NLTK
Tits	Lemmatization di nltk
Olaf	NLTK
Jeff	NLTK
Firth	NLTK
BR	Huruf Besar Semua
Bilal	Kebi
Windu	Kebi
Sanger	NLTK
Vijay	NLTK
Reasoner	NLTK
Raj	NLTK
Ni	Kebi
Laksmi	Kebi
Cornelia	NLTK
Cole	NLTK
Beau	NLTK
Puncheon	NLTK
Zed	NLTK
Cinderella	NLTK
Dadali	Kebi
Petr	NLTK
Dean	NLTK
Cahill	NLTK
Gonzalo	NLTK
Overload	NLTK
Sammy	NLTK
Ruth	NLTK
Dudu	Kebi
Panda	NLTK
Meggy	NLTK
Dame	Kebi
Asking	Lemmatization di nltk
Cartes	Lemmatization di nltk
Pasha	NLTK
Kusen	Kebi
Suzanne	NLTK
Orlando	NLTK
Darnel	NLTK
Aly	NLTK
Frost	NLTK
Evelyn	NLTK
Tengku	Kebi
Brenda	NLTK
Kat	NLTK
Fabian	NLTK
Cut	Kebi
Fuad	Kebi
VII	Romawi
Sita	Kebi
Abbey	NLTK
Mahdi	Kebi
Vang	NLTK
Swami	NLTK
L.	Satu kata bertitik
Vienna	NLTK
Nine	NLTK
Brawn	NLTK
Rini	Kebi
Palun	Kebi
Baby	NLTK
Whiting	NLTK
Sophia	NLTK
Joan	NLTK
David	NLTK
Bon	Kebi
H.M.A.	Satu kata bertitik
Fatah	Kebi
Carissa	NLTK
Hilary	NLTK
Inez	NLTK
E.H.	Satu kata bertitik
Arne	NLTK
Bando	Kebi
Marcella	NLTK
Inisiasi	Kebi
Morning	NLTK
Palma	Kebi
Jamin	Kebi
Hillary	NLTK
Ferly	NLTK
Bell	NLTK
Franklin	NLTK
Chip	NLTK
Mercedes	NLTK
Ci	Kebi
Granit	Kebi
Kabir	Kebi
Lara	Kebi
Gajah	Kebi
Asbak	Kebi
Bagus	Kebi
Lot	Kebi
Debbie	NLTK
Elvis	NLTK
Dolly	NLTK
Afiat	Kebi
Bullet	NLTK
Yabu	NLTK
Yaya	NLTK
Sabina	NLTK
Marian	NLTK
Hide	NLTK
Mayo	NLTK
XIII	Romawi
Matta	NLTK
Bird	NLTK
Lengkong	Kebi
Man	Kebi
Nyak	Kebi
Lamb	NLTK
Guyon	Kebi
Charlie	NLTK
So	NLTK
Agra	NLTK
Fighters	Lemmatization di nltk
Lu	Kebi
Phillip	NLTK
Limp	NLTK
Delima	Kebi
Revolver	Kebi
Selah	NLTK
Corinna	NLTK
Sir	Kebi
Clive	NLTK
Nile	NLTK
Willy	NLTK
Ban	Kebi
Agung	Kebi
Tabitha	NLTK
Sol	Kebi
Kemal	Kebi
Cros	Lemmatization di nltk
Suri	Kebi
Matter	NLTK
Vila	Kebi
Clinton	NLTK
Joe	NLTK
Abby	NLTK
Banks	Lemmatization di nltk
Son	NLTK
Moss	NLTK
Hatta	Kebi
Stain	NLTK
Dee	NLTK
Thatcher	NLTK
Baba	Kebi
Lev	NLTK
Omelette	NLTK
Sato	Kebi
Derby	NLTK
Temptation	NLTK
Noel	NLTK
Iso	NLTK
Barrow	NLTK
Saura	NLTK
Malik	Kebi
Troy	NLTK
Jemaah	Kebi
Goof	NLTK
Andy	NLTK
Sin	Kebi
Soto	Kebi
Attar	NLTK
Pole	NLTK
Smit	NLTK
Mohr	NLTK
Sai	Kebi
Harta	Kebi
Love	NLTK
Artha	NLTK
Rahman	Kebi
Alexandra	NLTK
Brent	NLTK
Debby	NLTK
Gaby	NLTK
Sani	Kebi
Brook	NLTK
Dandi	Kebi
Hazard	NLTK
Tema	Kebi
Doug	NLTK
Mendes	Lemmatization di nltk
R.M.S.	Satu kata bertitik
March	NLTK
Morbid	NLTK
Dika	NLTK
Selena	NLTK
Peron	Kebi
Shay	NLTK
Ilya	NLTK
Polk	NLTK
Lens	Kebi
Delapan	Kebi
Cetera	Kebi
Vino	NLTK
Bin	Kebi
Agnes	NLTK
Fajar	Kebi
Dorman	Kebi
Bowles	Lemmatization di nltk
Catherine	NLTK
Zo	NLTK
Ada	Kebi
Bony	NLTK
Ilham	Kebi
Chris	NLTK
Pantelis	NLTK
Marsha	NLTK
Kou	NLTK
Sonic	NLTK
Conte	NLTK
Casey	NLTK
Mahatma	Kebi
Chiles	Lemmatization di nltk
Adnan	Kebi
Micah	NLTK
Clara	NLTK
Pascual	NLTK
N.	Satu kata bertitik
Cana	NLTK
Basta	NLTK
Sibylla	NLTK
Bae	NLTK
Clint	NLTK
Monteith	NLTK
Emil	NLTK
Penelope	NLTK
Lil	Kebi
Mindi	Kebi
Levels	Lemmatization di nltk
Tae	NLTK
Didong	Kebi
Gosling	NLTK
Lech	NLTK
High	NLTK
PUSHIM	Huruf Besar Semua
Garang	Kebi
Isabella	NLTK
Dendi	Kebi
Daud	NLTK
Dicky	NLTK
Punjabi	NLTK
Guna	Kebi
Oh	Kebi
JUMP	NLTK
Spiegel	NLTK
Avian	NLTK
Yuris	Kebi
Will.i.am	Satu kata bertitik
Justo	NLTK
Silva	NLTK
Downing	NLTK
Ting	Kebi
Furlan	NLTK
Vic	NLTK
Gaus	NLTK
Marilyn	NLTK
Coates	Lemmatization di nltk
Jati	Kebi
Ha	Kebi
Mila	NLTK
Guruh	Kebi
No	Kebi
Setia	Kebi
Dennis	NLTK
VIII	Romawi
Sam	NLTK
Russian	NLTK
Kalas	Kebi
Ante	NLTK
Queen	NLTK
Hillel	NLTK
Danielle	NLTK
Alo	NLTK
Venkata	NLTK
Pol	Kebi
Carmen	NLTK
Rand	NLTK
Kasino	Kebi
Wira	Kebi
Terence	NLTK
S.O.S	Satu kata bertitik
Tegal	Kebi
Kung	Kebi
Ronni	NLTK
H.M.	Satu kata bertitik
Tamsil	Kebi
Wiji	Kebi
Earworm	NLTK
Fanning	NLTK
Neve	NLTK
Novel	Kebi
Adam	NLTK
Ghazi	NLTK
MBLAQ	Huruf Besar Semua
Capra	NLTK
Abdi	Kebi
List	NLTK
Gamma	Kebi
Storm	NLTK
Dewa	Kebi
Bah	Kebi
Eurythmics	NLTK
Mantik	Kebi
Lyra	NLTK
Armida	NLTK
Milner	NLTK
Ed	NLTK
Cempaka	Kebi
Pahlavi	NLTK
Rafael	NLTK
Libels	Lemmatization di nltk
Nina	NLTK
Wisdom	NLTK
Enid	NLTK
Johnny	NLTK
Rajiv	NLTK
Ahlan	Kebi
Klem	Kebi
Badge	NLTK
Pitau	NLTK
Color	NLTK
Candra	Kebi
Beck	NLTK
Timo	NLTK
Brandon	NLTK
Herman	NLTK
Mascara	NLTK
Diego	NLTK
Party	NLTK
Daryl	NLTK
Talib	Kebi
Garden	NLTK
Artie	NLTK
Hari	Kebi
Rock	NLTK
Omer	NLTK
Ohm	Kebi
Judas	NLTK
Camus	NLTK
Grant	NLTK
Steno	Kebi
Mortimer	NLTK
Dragon	Kebi
Paisley	NLTK
Mesut	Kebi
Wilfred	NLTK
Nikolai	NLTK
Al	Kebi
Stefan	NLTK
Norbert	NLTK
Warni	Kebi
Floyd	NLTK
Barak	Kebi
Murad	Kebi
Anderson	NLTK
Wanda	Kebi
F	NLTK
Lex	NLTK
Men	NLTK
Amil	Kebi
Lasso	NLTK
Monkey	NLTK
Bond	NLTK
Bourdon	NLTK
Curl	NLTK
Husbands	Lemmatization di nltk
Leslie	NLTK
Rain	NLTK
Boni	NLTK
Alberto	NLTK
Maggie	NLTK
Agam	Kebi
Rhodes	NLTK
Teng	Kebi
Kembang	Kebi
Mandala	Kebi
Isabelle	NLTK
Cici	Kebi
Duma	NLTK
MH.	Satu kata bertitik
Peyton	NLTK
Li	NLTK
Firman	NLTK
Sola	NLTK
JYJ	Huruf Besar Semua
Chromy	NLTK
Wendy	NLTK
Hijab	Kebi
Goni	Kebi
Funky	NLTK
A.N.	Satu kata bertitik
Marion	NLTK
Karina	Kebi
Danuri	NLTK
Chapman	NLTK
Persada	Kebi
Hiroyuki	NLTK
Flo	NLTK
Nat	NLTK
Blind	NLTK
Kotoko	NLTK
Prima	Kebi
Hal	Kebi
Manga	NLTK
Gwen	NLTK
TOR	NLTK
Iwa	NLTK
Broccoli	NLTK
Kota	Kebi
Lian	Kebi
Zat	Kebi
City	NLTK
Elle	NLTK
Perry	NLTK
Vanessa	NLTK
Antony	NLTK
Trier	NLTK
Nicolas	NLTK
Rijal	Kebi
Sparrow	NLTK
Elm	NLTK
Hilaria	NLTK
Frederik	NLTK
Ronald	NLTK
Habibi	Kebi
Solar	Kebi
Villas	Lemmatization di nltk
Constant	NLTK
Julien	NLTK
Patrice	NLTK
Topsy	NLTK
Mighty	NLTK
Susie	NLTK
Alan	NLTK
Patrick	NLTK
Warren	NLTK
Ramsey	NLTK
K.Will	Satu kata bertitik
Haya	NLTK
SEAMO	Huruf Besar Semua
Moch.	Satu kata bertitik
Goodwill	NLTK
Sabbath	NLTK
Les	Kebi
Children	Lemmatization di nltk
Mumpuni	Kebi
Abidal	NLTK
Donal	NLTK
Close	NLTK
Nanda	Kebi
Cheng	NLTK
Anak	Kebi
Till	NLTK
Lupus	NLTK
Group	NLTK
Jeanette	NLTK
Romaine	NLTK
Cornish	NLTK
Helder	NLTK
Jerun	Kebi
Octavia	NLTK
Jun	Kebi
Basir	Kebi
Hilda	NLTK
Pamungkas	Kebi
Ratna	Kebi
Hammer	NLTK
Cardona	NLTK
Savant	NLTK
Darren	NLTK
Chun	NLTK
Blaine	NLTK
Murat	NLTK
Hamzah	Kebi
Soler	NLTK
Putra	Kebi
Fanny	NLTK
Paredes	Lemmatization di nltk
Washington	NLTK
Bloom	NLTK
Fire	NLTK
Jet	Kebi
Lewis	NLTK
Toledo	NLTK
Kanon	Kebi
Dag	NLTK
Crows	Lemmatization di nltk
Bora	Kebi
Parker	NLTK
Bosch	NLTK
Guillermo	NLTK
Titian	NLTK
Jade	NLTK
Fosse	NLTK
Ade	NLTK
Burr	NLTK
Brett	NLTK
Diah	Kebi
Rudi	Kebi
Waters	Lemmatization di nltk
Mata	Kebi
Even	NLTK
Weekend	NLTK
Na	Kebi
Dodd	NLTK
Mantra	Kebi
Andreas	NLTK
Welles	Lemmatization di nltk
Beatrice	NLTK
Pangestu	Kebi
Muara	Kebi
Sala	Kebi
Sinaga	Kebi
Tuan	Kebi
of	NLTK
Awal	Kebi
Ucu	Kebi
B.o.B	Satu kata bertitik
Lux	NLTK
Mr.	Satu kata bertitik
Proctor	NLTK
By	NLTK
Mulder	NLTK
Eldin	NLTK
Las	Kebi
Martin	NLTK
Yana	NLTK
Alphonse	NLTK
Dora	NLTK
Taw	NLTK
Rosary	NLTK
PJ	Huruf Besar Semua
Chuck	NLTK
Tubagus	Kebi
Sunrise	NLTK
Vamps	Lemmatization di nltk
Levy	NLTK
Teller	NLTK
Shearer	NLTK
Augustin	NLTK
Sook	NLTK
Chrissie	NLTK
Datuk	Kebi
Habib	Kebi
P.	Satu kata bertitik
Kanjeng	Kebi
Dorado	NLTK
Scissor	NLTK
Alison	NLTK
Saka	Kebi
Ide	Kebi
Au	Kebi
Solis	Kebi
Jennifer	NLTK
Ford	NLTK
Kees	NLTK
Ardi	Kebi
Philippe	NLTK
Secondhand	NLTK
Mariana	NLTK
Kuang	Kebi
Jonathan	NLTK
Herd	NLTK
Bode	NLTK
Berry	NLTK
Chloe	NLTK
Stamp	NLTK
Guava	NLTK
Monster	Kebi
Duk	Kebi
baron	Kebi
R.Hartono	Satu kata bertitik
Rachel	NLTK
Volta	NLTK
Norma	Kebi
Dominique	NLTK
Syam	Kebi
Monty	NLTK
Blanca	NLTK
Lai	Kebi
Chili	NLTK
Dharma	NLTK
de	Kebi
Tress	NLTK
Radius	Kebi
Patil	Kebi
Christian	NLTK
Raven	NLTK
Paku	Kebi
Tatang	Kebi
Derrick	NLTK
RedOne	Lemmatization di nltk
Ferrara	NLTK
Warp	NLTK
Atmo	NLTK
Gaga	Kebi
Hysteric	NLTK
Bailee	NLTK
Rocks	Lemmatization di nltk
Hayes	Lemmatization di nltk
Woods	Lemmatization di nltk
Woe	NLTK
Kahin	Kebi
Miss	Kebi
R.	Satu kata bertitik
Feist	NLTK
Santiago	NLTK
Thierry	NLTK
Serigala	Kebi
Sonny	NLTK
Granat	Kebi
Cakar	Kebi
Ferry	NLTK
Hans	NLTK
Paco	NLTK
Abas	NLTK
Babcock	NLTK
Strong	NLTK
Routh	NLTK
Gibson	NLTK
TLB	Huruf Besar Semua
dan	Kebi
Youth	NLTK
Sein	Kebi
Serrano	NLTK
Padang	Kebi
Tasty	NLTK
Sander	NLTK
Gladstone	NLTK
Bintang	Kebi
Foreman	NLTK
Berger	NLTK
Unique	NLTK
Bunker	Kebi
Bianchi	NLTK
Sanda	Kebi
Downs	Lemmatization di nltk
Then	NLTK
Baca	Kebi
Semak	Kebi
Elliot	NLTK
SWAMI	NLTK
Rove	NLTK
Bain	Kebi
Taur	Kebi
Russell	NLTK
Edmund	NLTK
Tomas	NLTK
Ali	Kebi
Ben	NLTK
Rafi	Kebi
Clayton	NLTK
Cathy	NLTK
Is	NLTK
Ara	Kebi
Peto	NLTK
Pace	Kebi
Burns	Lemmatization di nltk
Stephanie	NLTK
Oar	NLTK
Liza	NLTK
Paola	NLTK
Kiat	Kebi
Sakura	Kebi
Koto	NLTK
Vina	NLTK
My	NLTK
Cedric	NLTK
Garda	Kebi
Outlandish	NLTK
Fatur	Kebi
Kitty	NLTK
Tara	Kebi
Eros	NLTK
I.	Satu kata bertitik
Sheares	Lemmatization di nltk
Chambers	Lemmatization di nltk
Boral	NLTK
Schiller	NLTK
Stallman	NLTK
Sunan	Kebi
Sunu	Kebi
Paula	NLTK
Kawin	Kebi
Caid	NLTK
Toldo	NLTK
Mutu	Kebi
Brained	Lemmatization di nltk
Vincenzo	NLTK
Petter	NLTK
TJ	Huruf Besar Semua
Cyril	NLTK
Narendra	NLTK
Aga	Kebi
Jarvis	NLTK
Taji	Kebi
Bonds	Lemmatization di nltk
Seok	Kebi
Yakin	Kebi
Jive	NLTK
Ishmael	NLTK
Taufik	Kebi
Melati	Kebi
ST	NLTK
Damayanti	NLTK
American	NLTK
Endang	Kebi
Porter	NLTK
Mak	Kebi
Safar	Kebi
Pat	NLTK
Abel	NLTK
Dara	Kebi
Maman	Kebi
Costas	Lemmatization di nltk
Pete	NLTK
Privat	Kebi
Calista	NLTK
Learns	Lemmatization di nltk
Bangun	Kebi
Pratt	NLTK
Maia	NLTK
WaT	NLTK
Servet	NLTK
Romney	NLTK
dal	Kebi
Naomi	NLTK
Perot	Kebi
Cak	Kebi
Grange	NLTK
Alchemy	NLTK
Jaguar	Kebi
Satria	Kebi
June	NLTK
Kana	Kebi
Greg	NLTK
Seven	NLTK
Pompadour	NLTK
Milan	NLTK
Run-D.M.C.	Satu kata bertitik
Rau	Kebi
Panca	Kebi
Taras	Kebi
Sapta	Kebi
Adlai	NLTK
B.F.	Satu kata bertitik
Pamela	NLTK
Sawai	Kebi
Eli	NLTK
Stern	NLTK
Clarence	NLTK
Justine	NLTK
Cohen	NLTK
Zain	NLTK
Juni	Kebi
Saif	Kebi
Ujang	Kebi
Ya	Kebi
Dominic	NLTK
Bagong	Kebi
Ne	NLTK
Aram	Kebi
Corey	NLTK
Lulu	NLTK
Siti	Kebi
Loren	NLTK
Andries	NLTK
Balthasar	NLTK
Chilla	NLTK
Craven	NLTK
Irving	NLTK
Anima	NLTK
Dozer	NLTK
Pandu	Kebi
Rather	NLTK
J.	Satu kata bertitik
Boyer	NLTK
Claude	NLTK
Zalim	Kebi
JP	Huruf Besar Semua
Angela	NLTK
Turco	NLTK
Cabot	NLTK
Bramble	NLTK
Lin	Kebi
Aguinaldo	NLTK
K.	Satu kata bertitik
Diana	NLTK
T.B.	Satu kata bertitik
Farmer	NLTK
Electric	NLTK
Heart	NLTK
Ricardo	NLTK
Predator	Kebi
Illinois	NLTK
Evangeline	NLTK
diri	Kebi
Nana	NLTK
Pollock	NLTK
Wei	NLTK
Junior	Kebi
Bo	NLTK
Revival	NLTK
Annette	NLTK
Loy	NLTK
Salomon	NLTK
Syed	NLTK
A.A.	Satu kata bertitik
Duff	NLTK
Tani	Kebi
Edar	Kebi
Violet	Kebi
Kiki	NLTK
Leonard	NLTK
Pong	NLTK
Quintet	NLTK
Anon	NLTK
SM	Huruf Besar Semua
Phoebe	NLTK
Ananda	Kebi
Vampire	NLTK
Arya	Kebi
Chitra	NLTK
Madonna	NLTK
Ike	NLTK
Ian	NLTK
Mouth	NLTK
Lengah	Kebi
Hopper	NLTK
Jean-Christophe	NLTK
Naoto	NLTK
Firdaus	Kebi
Money	NLTK
Miro	NLTK
Markus	NLTK
Glean	NLTK
Tania	Kebi
Cassius	NLTK
Garuda	Kebi
Oliver	NLTK
Pedro	NLTK
Cheney	NLTK
Jeremy	NLTK
Valencia	NLTK
Untouchable	NLTK
Matti	NLTK
Rajesh	NLTK
Mian	NLTK
Malam	Kebi
Sak	Kebi
Rubik	Kebi
Burke	NLTK
Loris	NLTK
Munshi	NLTK
Efendi	Kebi
Holt	NLTK
Mutiara	Kebi
Asian	NLTK
Erick	NLTK
Hanks	Lemmatization di nltk
Permaisuri	Kebi
Temin	Kebi
Vicky	NLTK
Knowledge	NLTK
James	NLTK
Purba	Kebi
Eta	Kebi
Wahyu	Kebi
Supertramp	NLTK
Garth	NLTK
Godfrey	NLTK
Porno	Kebi
Krista	Kebi
Try	NLTK
Rosalia	NLTK
Gottlieb	NLTK
Lan	NLTK
IX	Romawi
San	NLTK
Malih	Kebi
Music	NLTK
Grazer	NLTK
Ok	NLTK
Santon	NLTK
Dixie	NLTK
Tempest	NLTK
Kai	NLTK
Nestor	NLTK
Chickens	Lemmatization di nltk
Indri	NLTK
Villar	NLTK
Nila	Kebi
Fi	NLTK
Spice	NLTK
E.J.	Satu kata bertitik
Oliphant	NLTK
Alien	NLTK
W.D.	Satu kata bertitik
Spearing	NLTK
Ralf	NLTK
Paus	Kebi
Amin	Kebi
Mi	Kebi
Jessica	NLTK
Melon	NLTK
van	NLTK
Harmony	NLTK
Hugh	NLTK
Ric	NLTK
Dakota	NLTK
Azali	Kebi
Jin	Kebi
Monkeys	Lemmatization di nltk
Moi	NLTK
Fortunella	NLTK
Collins	NLTK
Hawer	NLTK
Brian	NLTK
Dewi	Kebi
Hirofumi	NLTK
Donald	NLTK
Mark	Kebi
Isabel	NLTK
Vital	Kebi
Foo	NLTK
Bradford	NLTK
Bram	NLTK
Mas	Kebi
Jaime	NLTK
Permata	Kebi
IU	Huruf Besar Semua
Anom	Kebi
Otis	NLTK
Scaloni	NLTK
Hemed	Lemmatization di nltk
Anyang	Kebi
Sierra	NLTK
U.	Satu kata bertitik
Gillian	NLTK
Yoga	Kebi
Randolph	NLTK
Sue	NLTK
Annie	NLTK
Mulia	Kebi
Roses	Lemmatization di nltk
Chamorro	NLTK
Jamrud	Kebi
Syamsu	Kebi
Cuthbert	NLTK
Kasah	Kebi
Ucok	Kebi
Ledger	NLTK
Hu	NLTK
Baldwin	NLTK
to	Kebi
Buyung	Kebi
Francis	NLTK
AG	Huruf Besar Semua
Atik	NLTK
Lois	NLTK
Samudra	Kebi
Pata	NLTK
Rubin	Kebi
Roach	NLTK
Toro	Kebi
Martins	Lemmatization di nltk
Natalia	NLTK
Kama	Kebi
Basil	Kebi
Larry	NLTK
Denys	Lemmatization di nltk
Khadam	Kebi
Pennant	NLTK
Simeon	NLTK
Leah	NLTK
Aruan	Kebi
Panji	Kebi
Neto	Kebi
Tabah	Kebi
K	NLTK
York	NLTK
Bryan	NLTK
Universitas	Kebi
Lula	NLTK
Perrier	NLTK
Jamal	Kebi
Portia	NLTK
Date	NLTK
Santa	Kebi
Elijah	NLTK
Bertram	NLTK
Bob	NLTK
Hicks	Lemmatization di nltk
Nur	Kebi
Kathy	NLTK
Rani	Kebi
Rian	Kebi
Cho	NLTK
Gamal	Kebi
Tora	NLTK
Belcher	NLTK
Jean	NLTK
Kevin	NLTK
Signori	Lemmatization di nltk
Spencer	NLTK
Crosse	NLTK
Bonar	Kebi
Cool	NLTK
Bent	NLTK
Church	NLTK
Phil	NLTK
Cheshire	NLTK
Roger	NLTK
Marcel	NLTK
Barkas	Kebi
Trump	NLTK
Havel	NLTK
Priest	NLTK
Bless	NLTK
Helm	Kebi
Sandal	Kebi
Emerald	NLTK
Fenny	NLTK
Julian	NLTK
Nadi	Kebi
Sergiu	NLTK
Casper	NLTK
Hale	NLTK
Lynn	NLTK
Toby	NLTK
Joseph	NLTK
Rush	NLTK
Coventry	NLTK
Di	Kebi
Avery	NLTK
Cam	Kebi
Johannes	NLTK
Adela	NLTK
Morel	NLTK
Sayed	Lemmatization di nltk
Syahid	Kebi
Holland	NLTK
Death	NLTK
Kristiani	Kebi
Ihsan	Kebi
Christos	NLTK
Goodyear	NLTK
Abadi	Kebi
Jones	NLTK
Puput	Kebi
Duchess	NLTK
Jean-Pierre	NLTK
Schreiner	NLTK
TUN	Kebi
Josiah	NLTK
AJ	Huruf Besar Semua
Curie	NLTK
Atta	NLTK
ten	NLTK
Anes	NLTK
Mario	NLTK
Sick	NLTK
Joyce	NLTK
Bahadur	Kebi
Back	NLTK
Amedeo	NLTK
Sr.	Satu kata bertitik
Sampurna	Kebi
Elia	NLTK
Tulung	Kebi
Jibril	Kebi
Head	NLTK
G	NLTK
Leighton	NLTK
Darryl	NLTK
Havens	Lemmatization di nltk
F.H.	Satu kata bertitik
Lacks	Lemmatization di nltk
Barney	NLTK
Mong	Kebi
Poulter	NLTK
Todd	NLTK
Samuel	NLTK
Ter	Kebi
Symphony	NLTK
Driver	NLTK
Aban	Kebi
Ebenezer	NLTK
Zone	Kebi
Frankenstein	NLTK
MZ	Huruf Besar Semua
Coker	NLTK
den	Kebi
Pina	NLTK
Guy	NLTK
Anthony	NLTK
Keita	NLTK
E.S.	Satu kata bertitik
Steve	NLTK
Camilla	NLTK
Kano	Kebi
Psychic	NLTK
Alpha	NLTK
Ham	Kebi
Kings	Lemmatization di nltk
Okie	NLTK
Lukas	NLTK
Bridget	NLTK
Pepper	NLTK
Martyn	NLTK
Freddy	NLTK
Paris	Kebi
Geraldine	NLTK
Bass	NLTK
Nance	NLTK
Nahas	Kebi
Borne	NLTK
Astor	NLTK
Bruno	NLTK
Conrad	NLTK
Apostolos	NLTK
D.o.t	Satu kata bertitik
Risa	Kebi
Diamond	NLTK
Incubus	NLTK
Reed	NLTK
Agre	NLTK
Irfan	NLTK
Chi	NLTK
Pasteur	Kebi
Patel	NLTK
LVT	Huruf Besar Semua
Saadah	Kebi
Alam	Kebi
Kumala	Kebi
Atef	NLTK
Abd.Rahim	Satu kata bertitik
Billie	NLTK
Hakim	Kebi
Buddy	NLTK
Cain	NLTK
Ella	NLTK
Won	NLTK
Bill	NLTK
Saber	NLTK
Tegar	Kebi
C.T.R.	Satu kata bertitik
Jam	Kebi
Muntu	Kebi
Max	NLTK
Sonja	NLTK
Harvey	NLTK
Gayatri	NLTK
Miller	NLTK
Setiawan	Kebi
Levin	NLTK
Loo	NLTK
Butch	NLTK
Rainy	NLTK
Patricio	NLTK
Ah	Kebi
Lynne	NLTK
Billa	NLTK
Satar	Kebi
Crow	NLTK
Islam	Kebi
Chol	NLTK
Cucu	Kebi
Barbara	NLTK
Seri	Kebi
Bun	Kebi
Wilhelm	NLTK
II	Romawi
Titien	NLTK
Kyle	NLTK
Cassandra	NLTK
Teras	Kebi
CB	Huruf Besar Semua
Connie	NLTK
Rainbow	NLTK
Serra	NLTK
Yati	NLTK
Pical	NLTK
Reinhard	NLTK
Infanta	NLTK
Avenged	Lemmatization di nltk
Waltz	NLTK
Yip	NLTK
Birch	NLTK
Rena	Kebi
Siddhartha	NLTK
Samba	Kebi
Iga	Kebi
Ton	Kebi
Chinchilla	NLTK
G.H.	Satu kata bertitik
Gregg	NLTK
Chase	NLTK
Haab	NLTK
Prihatin	Kebi
Loukas	NLTK
Sun	Kebi
Dorothy	NLTK
Damon	NLTK
Kui	Kebi
Rebecca	NLTK
Law	NLTK
Brothers	Lemmatization di nltk
Cortez	NLTK
Camara	NLTK
Reginald	NLTK
Walsh	NLTK
Winchester	NLTK
Raymond	NLTK
Fitch	NLTK
Adu	Kebi
Scoot	NLTK
Mew	NLTK
Cates	Lemmatization di nltk
Karl	NLTK
Amadou	NLTK
Hi	Kebi
For	NLTK
Mustika	Kebi
Friend	NLTK
Fortune	NLTK
Nuke	NLTK
Suk	Kebi
Tain	NLTK
Hiram	NLTK
Stuart	NLTK
Simon	NLTK
Donovan	NLTK
Records	Lemmatization di nltk
Coelho	NLTK
Sakis	Lemmatization di nltk
Finch	NLTK
Munch	NLTK
Bonet	Kebi
Blinder	NLTK
Lawrence	NLTK
Jurnalis	Kebi
Titi	Kebi
Sulung	Kebi
Nigel	NLTK
Kafi	Kebi
Bradley	NLTK
Russ	NLTK
Twain	NLTK
Christopher	NLTK
Seymour	NLTK
Alen	NLTK
Swan	NLTK
Young	NLTK
Rica	Kebi
Case	NLTK
Karisma	Kebi
Jagger	NLTK
Bonnie	NLTK
Teresa	NLTK
Primus	NLTK
Kenneth	NLTK
U	Kebi
Amril	Kebi
Hotel	Kebi
Covey	NLTK
Jasper	NLTK
Jeffrey	NLTK
Mitchell	NLTK
Meri	Kebi
Louise	NLTK
Susumu	NLTK
Ream	NLTK
Yun	NLTK
Konstantinos	NLTK
Caesar	NLTK
Stan	Kebi
Lazy	NLTK
Buyar	Kebi
Keri	Kebi
Serge	NLTK
Kelik	Kebi
Maxim	NLTK
Piper	NLTK
Lloyd	NLTK
Zak	NLTK
Ring	Kebi
Dane	NLTK
George	NLTK
Gondrong	Kebi
Kin	Kebi
Kuini	Kebi
Puppies	Lemmatization di nltk
Schiavone	NLTK
Mango	NLTK
Pele	NLTK
Sora	NLTK
Kian	Kebi
Bum	Kebi
Guru	Kebi
Montana	NLTK
Mull	NLTK
Tom	Kebi
Gary	NLTK
Beni	Kebi
Rahim	Kebi
el	Kebi
Mafia	Kebi
Brin	NLTK
Kok	Kebi
D	NLTK
Note	NLTK
Semakin	Kebi
Gaspar	NLTK
Kamel	NLTK
Dinda	Kebi
Nira	Kebi
Sean	NLTK
Didik	Kebi
Padan	Kebi
Gradasi	Kebi
KDI	Huruf Besar Semua
Otto	NLTK
Sagitarius	Kebi
O.	Satu kata bertitik
Akbar	Kebi
Anjar	Kebi
Jessie	NLTK
Rode	NLTK
Wichita	NLTK
Blash	NLTK
Medan	Kebi
Dick	NLTK
Senda	Kebi
Tompel	Kebi
Ning	Kebi
Mena	Kebi
Rum	Kebi
Rod	NLTK
Zach	NLTK
Benson	NLTK
Shannon	NLTK
Joanna	NLTK
Ferguson	NLTK
Oskar	NLTK
Heidi	NLTK
Marcos	NLTK
Syd	NLTK
Both	NLTK
Ringer	NLTK
Eagles	Lemmatization di nltk
Lembu	Kebi
Duta	Kebi
Newton	Kebi
Suzan	NLTK
Wai	Kebi
Hero	Kebi
Masayu	Kebi
Hikam	Kebi
Scrooge	NLTK
Ba	Kebi
Sofia	NLTK
Perceval	NLTK
Marque	NLTK
Mao	NLTK
Iron	NLTK
Agatha	NLTK
Rupert	NLTK
Duri	Kebi
Ranty	NLTK
Nul	NLTK
Karti	Kebi
Nurse	NLTK
D.M.C.	Satu kata bertitik
Alexius	NLTK
Hugo	NLTK
Jerome	NLTK
Abate	NLTK
Morales	Lemmatization di nltk
Tano	NLTK
Hogan	NLTK
Khair	Kebi
Betet	Kebi
Hammerer	NLTK
Naib	Kebi
Sini	Kebi
Orchestra	NLTK
Nair	NLTK
Irama	Kebi
Shriver	NLTK
Ponce	NLTK
Gera	Kebi
Leman	NLTK
Lucian	NLTK
Stiller	NLTK
Kuno	Kebi
Paolo	NLTK
Vladimir	NLTK
Dwayne	NLTK
Rosario	Kebi
Jerry	NLTK
Farouk	NLTK
Kartika	Kebi
Senna	NLTK
Bas	Kebi
Canales	Lemmatization di nltk
Hare	NLTK
Karier	Kebi
JB	Huruf Besar Semua
Sheila	NLTK
Sara	Kebi
Jorge	NLTK
Del	NLTK
Alexis	NLTK
Victor	NLTK
Brittany	NLTK
Skinner	NLTK
Lena	Kebi
Sync	NLTK
Kuan	NLTK
J.B.S.	Satu kata bertitik
Val	NLTK
Blur	NLTK
Sea	NLTK
Martini	Kebi
Starlets	Lemmatization di nltk
Magic	NLTK
Hunter	NLTK
Biram	Kebi
August	NLTK
Winter	Kebi
Pribadi	Kebi
Teck	NLTK
Wee	NLTK
T.T.	Satu kata bertitik
Speed	NLTK
St	NLTK
Acoustic	NLTK
Tommy	NLTK
Skillet	NLTK
Wedel	Kebi
Hong	NLTK
Sinyo	Kebi
Kids	NLTK
Ruan	Kebi
Lea	NLTK
Edwin	NLTK
Parto	NLTK
Mahardika	Kebi
Vives	NLTK
Bulan	Kebi
Coverage	NLTK
Gabor	Kebi
Douglas	NLTK
Elang	Kebi
Kasim	Kebi
Corona	NLTK
Dan	Kebi
Datar	Kebi
Stoker	Kebi
China	NLTK
Angelo	NLTK
Status	Kebi
Vivek	NLTK
Ted	NLTK
Woo	NLTK
Dirk	NLTK
Cecil	NLTK
Urs	NLTK
Gregor	NLTK
Evert	NLTK
Syukur	Kebi
Trinity	NLTK
XVIII	Huruf Besar Semua
TIO	Huruf Besar Semua
Anton	NLTK
PAS	Kebi
Yam	NLTK
Konrad	NLTK
Laurie	NLTK
Thuan	NLTK
Lester	NLTK
Brad	NLTK
Chains	Lemmatization di nltk
Child	NLTK
Daeng	Kebi
Asaph	NLTK
Hinds	Lemmatization di nltk
Helen	NLTK
Rahmat	Kebi
Curver	NLTK
NSG	Huruf Besar Semua
Takayuki	NLTK
Burton	NLTK
Sleep	NLTK
Gading	Kebi
Jamie	NLTK
Kencana	Kebi
Windsor	NLTK
Balanta	NLTK
Bos	Kebi
Yok	NLTK
Fey	NLTK
Moo	NLTK
Dyer	NLTK
Apple	NLTK
Tat	NLTK
Mayer	NLTK
Lith	NLTK
Slim	NLTK
Matthieu	NLTK
Dado	NLTK
Immobile	NLTK
Shankar	NLTK
Nebel	NLTK
Ammi	Kebi
Florence	NLTK
Haji	Kebi
Marco	NLTK
Brewster	NLTK
Galung	Kebi
Kazi	NLTK
Khalifah	Kebi
Spike	NLTK
Black	NLTK
Portman	NLTK
Poulard	NLTK
Sung	NLTK
Maya	Kebi
Bullock	NLTK
Erasmus	NLTK
Aki	Kebi
Cowboy	NLTK
Fry	NLTK
Miki	NLTK
Keyes	Lemmatization di nltk
Darwis	Kebi
Angelica	NLTK
Emilia	NLTK
Coda	NLTK
Buhl	NLTK
Khan	NLTK
Native	NLTK
Clavier	NLTK
Doping	Kebi
Swedish	NLTK
Laura	NLTK
Kamil	Kebi
Mukminin	Kebi
Robert	NLTK
Nusa	Kebi
Uriah	NLTK
Pierre	NLTK
Cilik	Kebi
Baruch	NLTK
EXO	Huruf Besar Semua
Mok	Kebi
Wen	NLTK
Pelt	NLTK
Skee	NLTK
Rosalind	NLTK
Abu	NLTK
Harper	NLTK
Luigi	NLTK
Earl	NLTK
Granger	NLTK
Serdar	NLTK
Sloan	NLTK
Alice	NLTK
Butler	NLTK
Cader	NLTK
Rabi	Kebi
Mamie	NLTK
Senate	NLTK
Lim	NLTK
Foxes	Lemmatization di nltk
Nathan	NLTK
Budi	Kebi
Starling	NLTK
Randi	Kebi
Sessions	NLTK
Yudo	Kebi
Seaman	NLTK
Rumi	Kebi
Audrey	NLTK
Red	NLTK
Ilir	Kebi
Gadis	Kebi
Nahak	Kebi
Curry	NLTK
Jason	NLTK
Bhutia	NLTK
Ron	NLTK
Amis	Kebi
Hart	Kebi
Filo	Kebi
Leigh	NLTK
Dt.	Satu kata bertitik
Mater	NLTK
Cruise	NLTK
Flitter	NLTK
Willie	NLTK
Viva	NLTK
Kalashnikov	NLTK
Lucky	NLTK
Slater	NLTK
Dumas	Lemmatization di nltk
Grey	NLTK
Sting	NLTK
W.J.	Satu kata bertitik
Nancy	NLTK
Trimurti	Kebi
Mus	Kebi
Dries	Lemmatization di nltk
Ramon	NLTK
Olga	NLTK
Begin	NLTK
Roque	NLTK
Wisnu	Kebi
Richard	NLTK
Jenny	NLTK
Hara	Kebi
Berlin	NLTK
Pesek	Kebi
Joey	NLTK
Gish	NLTK
Slank	NLTK
Marten	NLTK
Vladislav	NLTK
Squire	NLTK
Milla	NLTK
Sumpter	NLTK
Sidi	Kebi
Ayu	Kebi
Brilliant	NLTK
Boas	Lemmatization di nltk
Izumi	NLTK
Heather	NLTK
Sparks	NLTK
He	Kebi
Wan	Kebi
Hope	NLTK
Kipa	Kebi
Firasat	Kebi
Samudera	Kebi
FX	Huruf Besar Semua
Knudsen	NLTK
Giri	Kebi
Ping	NLTK
West	NLTK
Barker	NLTK
Michael	NLTK
Arcade	NLTK
Lover	NLTK
FM	Huruf Besar Semua
Owen	NLTK
Abe	NLTK
Usher	NLTK
Wilson	NLTK
Randy	NLTK
Kieran	NLTK
Adrian	NLTK
Belly	NLTK
Angsa	Kebi
Rufus	NLTK
Withers	NLTK
Raul	NLTK
Becky	NLTK
Smuts	Lemmatization di nltk
Prince	NLTK
Grab	NLTK
Berlian	Kebi
Jewel	NLTK
Mentari	Kebi
Kurt	NLTK
Dolphin	NLTK
Yuri	Kebi
Tori	Lemmatization di nltk
Sahara	Kebi
Neil	NLTK
Pape	NLTK
Reid	NLTK
Lady	NLTK
Tamam	Kebi
Doll	NLTK
Buchanan	NLTK
Adil	Kebi
Chain	NLTK
Julius	NLTK
Y.	Satu kata bertitik
Sally	NLTK
Long	Kebi
Messenger	NLTK
T.	Satu kata bertitik
Dire	NLTK
Art	NLTK
Tao	NLTK
Jake	NLTK
F.	Satu kata bertitik
Ranger	NLTK
Browning	NLTK
Ion	Kebi
Flea	NLTK
Town	NLTK
Way	NLTK
Irons	Lemmatization di nltk
Seng	Kebi
Ocean	NLTK
KAT	NLTK
Yes	NLTK
Neville	NLTK
Bunuh	Kebi
Home	NLTK
Chord	NLTK
Kreator	Kebi
Jalil	Kebi
Lenny	NLTK
Desi	NLTK
Lou	NLTK
Braid	NLTK
Maulana	Kebi
Kesuma	Kebi
Burman	NLTK
Fortes	Lemmatization di nltk
Clare	NLTK
Winona	NLTK
Franc	NLTK
Dudley	NLTK
Colin	NLTK
Kharisma	Kebi
Jobs	Lemmatization di nltk
Kirsten	NLTK
Merpati	Kebi
Sherman	NLTK
Beadle	NLTK
Morin	NLTK
Ansel	NLTK
Gees	Lemmatization di nltk
Inception	NLTK
Cowan	NLTK
Mammy	NLTK
Omar	NLTK
Cullen	NLTK
Gus	Kebi
Rochelle	NLTK
Lina	NLTK
Chicha	NLTK
Roon	NLTK
Emery	NLTK
Kanda	Kebi
Lucy	NLTK
Pater	Kebi
Bruce	NLTK
Last	NLTK
Advent	NLTK
Sumirat	Kebi
R.M.	Satu kata bertitik
Chou	NLTK
Bridge	NLTK
Sutra	Kebi
Pardo	NLTK
In	Kebi
Rowland	NLTK
Happy	NLTK
Bart	NLTK
Kalam	Kebi
Mami	Kebi
Gana	Kebi
Mai	Kebi
Clark	NLTK
Milo	NLTK
Boney	NLTK
Joachim	NLTK
Wall	NLTK
Ma	Kebi
Ernest	NLTK
Galih	Kebi
Jr.	Satu kata bertitik
Sang	Kebi
Rai	Kebi
Zaman	Kebi
Gamble	NLTK
Teddy	NLTK
Tukar	Kebi
Sancho	NLTK
Kent	NLTK
Learn	NLTK
hitam	Kebi
Khalifa	NLTK
Saul	NLTK
Nobs	NLTK
Garrison	NLTK
Robin	NLTK
Carter	Kebi
Dude	NLTK
Santo	Kebi
Gunung	Kebi
Yang	Kebi
Bajang	Kebi
Made	NLTK
Stoner	NLTK
Surya	Kebi
Delbert	NLTK
Suh	Kebi
Eliza	NLTK
Ball	NLTK
Cakra	Kebi
Sharp	NLTK
Guana	NLTK
Kusuma	Kebi
Theodore	NLTK
You	NLTK
Ladin	NLTK
Moudy	NLTK
MS	Huruf Besar Semua
Humphrey	NLTK
Antigone	NLTK
Pablo	NLTK
Zinnia	NLTK
Edmond	NLTK
Chandler	NLTK
Bennet	NLTK
Lila	Kebi
Samaras	Lemmatization di nltk
Book	NLTK
Liv	NLTK
Warman	NLTK
Masyarakat	Kebi
Guntur	Kebi
Sewaka	Kebi
Kick	NLTK
Steeve	NLTK
Tony	NLTK
Hud	NLTK
XI	NLTK
Kroto	Kebi
Luak	Kebi
Hackman	NLTK
Fender	NLTK
Velvet	NLTK
Jara	Kebi
Sisters	Lemmatization di nltk
Kelvin	NLTK
Seme	NLTK
Margie	NLTK
Olson	NLTK
Samantha	NLTK
Frederick	NLTK
Wilhelmina	NLTK
Senses	Lemmatization di nltk
Claire	NLTK
Bowker	NLTK
Jesse	NLTK
Aurelia	NLTK
Bowery	NLTK
Ching	NLTK
Enow	NLTK
Tour	NLTK
An	NLTK
Insigne	NLTK
Ashraf	NLTK
Dr.PM	Satu kata bertitik
Sio	Kebi
O.B.	Satu kata bertitik
P.R.	Satu kata bertitik
Aam	NLTK
Charles	NLTK
MZA	Huruf Besar Semua
Railroad	NLTK
Percy	NLTK
Romance	NLTK
Steppe	NLTK
Marie	NLTK
Medina	NLTK
Sabines	Lemmatization di nltk
Hertz	Kebi
Shaw	NLTK
Lane	NLTK
Gervais	NLTK
Klaus	NLTK
Anduk	Kebi
Out	NLTK
Heinz	NLTK
Beha	Kebi
Hurley	NLTK
Romeo	NLTK
AC	Huruf Besar Semua
Pot	Kebi
Cello	NLTK
Hello	NLTK
Skye	NLTK
Posey	NLTK
Carnegie	NLTK
Saturday	NLTK
Ari	Kebi
Bellow	NLTK
Crouch	NLTK
DC	Huruf Besar Semua
Abang	Kebi
Ann	NLTK
Solomon	NLTK
Crazy	NLTK
Carrie	NLTK
One	NLTK
Wolfgang	NLTK
Koki	Kebi
Paul	Kebi
Anil	Kebi
Amal	Kebi
Rafik	Kebi
Dido	NLTK
Bee	NLTK
Banda	Kebi
R.A.	Satu kata bertitik
Erie	NLTK
Bragi	NLTK
Alfred	NLTK
Jon	NLTK
Rolls	Lemmatization di nltk
Fleming	NLTK
Philharmonic	NLTK
Aji	Kebi
Sergio	NLTK
Thirteen	NLTK
XYZ	Huruf Besar Semua
Woodward	NLTK
Mada	Kebi
Martinez	NLTK
Muriel	NLTK
Tunggang	Kebi
Anan	NLTK
Grand	NLTK
ter	Kebi
Chia	NLTK
Gal	NLTK
Bundy	NLTK
Topan	Kebi
Koller	NLTK
White	NLTK
Gula	Kebi
Reda	Kebi
Maduro	NLTK
Franks	Lemmatization di nltk
Tobias	NLTK
Ida	Kebi
Chicks	Lemmatization di nltk
Jose	NLTK
Edith	NLTK
Oyong	Kebi
Super	Kebi
Hadji	NLTK
Bloc	NLTK
Delap	Kebi
Petty	NLTK
Doris	NLTK
Boyd	NLTK
Mbah	Kebi
Rosales	NLTK
Star	NLTK
Tarkas	Kebi
Laksamana	Kebi
Sissy	NLTK
Booker	NLTK
Sarah	NLTK
Ajun	Kebi
Hoddle	NLTK
Rupiah	Kebi
Torsten	NLTK
SISTAR	Huruf Besar Semua
yang	Kebi
Gunnar	NLTK
Blatter	NLTK
Syekh	Kebi
Takeuchi	NLTK
Rainer	NLTK
Muslimin	Kebi
Jacob	NLTK
Kittel	NLTK
Lionel	NLTK
Bam	Kebi
Good	NLTK
La	Kebi
Suir	Kebi
Peggy	NLTK
Vincent	NLTK
Cicip	Kebi
Katy	NLTK
Owl	NLTK
Eon	Kebi
Lola	NLTK
Jukes	Lemmatization di nltk
Slot	NLTK
Tertius	NLTK
Senat	Kebi
Chet	NLTK
Power	NLTK
Jiwa	Kebi
Streep	NLTK
Peri	Kebi
F.X.	Satu kata bertitik
Mercer	NLTK
Z	Kebi
Gin	Kebi
Junius	NLTK
Ash	NLTK
Mahkota	Kebi
Prakash	NLTK
Fisher	NLTK
Tampi	Kebi
Light	NLTK
Una	NLTK
Fred	NLTK
Basat	Kebi
Effendi	NLTK
Evanescence	NLTK
Flock	NLTK
Delia	NLTK
Tile	Kebi
C.S.	Satu kata bertitik
Tike	Kebi
Mikey	NLTK
Paulus	NLTK
Kuman	Kebi
Marques	Lemmatization di nltk
Cornelius	NLTK
Eddie	NLTK
Island	NLTK
Jenna	NLTK
Helena	NLTK
Bucky	NLTK
Kaj	NLTK
Webber	NLTK
Numa	NLTK
H.O.T.	Satu kata bertitik
Rhoda	NLTK
Leila	NLTK
Amanda	NLTK
Han	NLTK
Daya	Kebi
Rahmatullah	Kebi
Singleton	NLTK
Toh	Kebi
Esperance	NLTK
Bagi	Kebi
Snicket	NLTK
Gu	Kebi
Suci	Kebi
Tengker	Kebi
Natalie	NLTK
Lemony	NLTK
Fox	NLTK
Miguel	NLTK
De	Kebi
Poppy	NLTK
Si	Kebi
Adelia	NLTK
Jack	NLTK
Boris	NLTK
Ahsan	Kebi
Lear	NLTK
Wong	Kebi
Wiles	Lemmatization di nltk
Capote	NLTK
Woodrow	NLTK
Tucker	NLTK
Nye	NLTK
Keith	NLTK
Frangipane	NLTK
Maliki	Kebi
Rasyid	Kebi
Benn	NLTK
Fuller	NLTK
Abbas	NLTK
Jeanne	NLTK
Dewan	Kebi
Pine	NLTK
Bravo	NLTK
Sigmund	NLTK
Checker	NLTK
Lovelock	NLTK
Sears	Lemmatization di nltk
by	NLTK
Bryce	NLTK
Karen	NLTK
Lance	NLTK
Funeral	NLTK
Pike	Kebi
Udo	Kebi
Sidney	NLTK
Wade	NLTK
Keen	NLTK
Manuel	NLTK
Doke	NLTK
Danic	NLTK
Arnold	NLTK
y	NLTK
Gottfried	NLTK
Bottoms	Lemmatization di nltk
Root	NLTK
Morgan	NLTK
Samad	Kebi
Longo	Kebi
Carlo	NLTK
Cliff	NLTK
Esa	Kebi
D.O.	Satu kata bertitik
Leung	NLTK
Garibaldi	NLTK
Stanley	NLTK
Anne	NLTK
Christofer	NLTK
Japan	NLTK
Toto	NLTK
Foster	NLTK
Ira	Kebi
Christ	NLTK
Daft	NLTK
Austin	NLTK
Sosiawan	Kebi
Cha	NLTK
Judy	NLTK
Mouse	NLTK
G.	Satu kata bertitik
Apel	Kebi
Alain	NLTK
Aurora	Kebi
R.S.	Satu kata bertitik
Ansari	Kebi
Led	NLTK
M	Kebi
Morris	NLTK
Suwandi	NLTK
Prakarsa	Kebi
Eileen	NLTK
Trice	NLTK
Mars	Kebi
Bom	Kebi
Warwick	NLTK
Braille	Kebi
Sari	Kebi
Ernst	NLTK
Leter	Kebi
Tanner	NLTK
Cacau	Kebi
Ferri	NLTK
Kim	Kebi
Syamsir	Kebi
Kribo	Kebi
Grace	NLTK
Gerard	NLTK
Rosier	NLTK
Stephan	NLTK
Dutra	NLTK
Pollack	NLTK
Carolyn	NLTK
Karet	Kebi
RTM	Huruf Besar Semua
Ridder	NLTK
Dera	Kebi
Shamir	NLTK
Glazer	NLTK
Boyce	NLTK
Hutch	NLTK
Sans	NLTK
Project	NLTK
Carmine	NLTK
D.I.	Satu kata bertitik
Nicky	NLTK
Dion	NLTK
Syafii	Kebi
Beverly	NLTK
Shah	NLTK
Blue	NLTK
Larin	NLTK
Day	NLTK
Lemari	Kebi
Curtis	NLTK
Melody	NLTK
Chick	NLTK
Boys	Lemmatization di nltk
Timothy	NLTK
Chin	NLTK
Miriam	NLTK
Zakiah	Kebi
Spall	NLTK
Tyrone	NLTK
Lily	NLTK
Betty	NLTK
T.R.I.A.D	Satu kata bertitik
Bishop	NLTK
H.C.	Satu kata bertitik
Tudor	NLTK
Soe	Kebi
Reis	NLTK
Suryani	Kebi
Kuning	Kebi
Amelia	NLTK
Horst	NLTK
Pinda	Kebi
Cyrus	NLTK
Puri	Kebi
Pierce	NLTK
Leonid	Kebi
Melodia	NLTK
Ole	NLTK
Mahmoud	NLTK
Salma	NLTK
Kris	NLTK
Kimberly	NLTK
Jawed	NLTK
Cary	NLTK
Vita	NLTK
Sanjay	NLTK
Dern	NLTK
Baker	NLTK
Judi	Kebi
El	Kebi
Elizabeth	NLTK
Dini	Kebi
Rudolf	NLTK
Rumor	Kebi
Frank	NLTK
Guan	NLTK
C.G.E.	Satu kata bertitik
MoJo	NLTK
Yellow	NLTK
Cok	Kebi
Henny	NLTK
Rahul	NLTK
Rajendra	NLTK
Antinous	NLTK
Maki	Kebi
Untung	Kebi
Octavian	NLTK
Tumpak	Kebi
Canterbury	NLTK
Gertrude	NLTK
Base	NLTK
Courtney	NLTK
Rudolph	NLTK
Mari	Kebi
e	Kebi
Chow	NLTK
Eaves	NLTK
Alvin	NLTK
Taruna	Kebi
Cesare	NLTK
Bunga	Kebi
Her	NLTK
Tripy	NLTK
Brock	NLTK
Train	NLTK
Bianco	NLTK
Naim	Kebi
Dian	Kebi
Gil	NLTK
Valiant	NLTK
Perwira	Kebi
Selva	NLTK
Sekret	Kebi
M.	Satu kata bertitik
Allan	NLTK
Burn	NLTK
Mamo	NLTK
Vernon	NLTK
Pu	NLTK
Mulligan	NLTK
Kandel	Kebi
Oleg	NLTK
Styles	Lemmatization di nltk
Parks	Lemmatization di nltk
Eloge	NLTK
Agus	Kebi
Adinda	Kebi
