Pinggan	Kebi
Giri	Kebi
Lalang	Kebi
Tetel	NLTK
Lumpur	Kebi
Roma	Kebi
Krakal	Kebi
Kepurun	Kebi
Dawan	Kebi
Cemara	Kebi
Alat	Kebi
Ribang	Kebi
Dari	Kebi
Bua	Kebi
Bogo	NLTK
Tuik	NLTK
Paniki	Kebi
Florence	NLTK
Web	NLTK
Rejeki	Kebi
Antique	NLTK
Mandala	Kebi
Randau	Kebi
Turangga	Kebi
Koka	Kebi
Rukam	Kebi
Tunggu	Kebi
Pimping	Kebi
Kabupaten	Kebi
Parak	Kebi
Gending	Kebi
Pisang	Kebi
Headland	NLTK
Semboja	Kebi
Bantayan	NLTK
Kidang	Kebi
Galang	Kebi
Langgam	Kebi
Lowa	NLTK
Subang	Kebi
Mali-Mali	Kebi
Pojok	Kebi
Gema	Kebi
Pangeran	Kebi
Riverside	NLTK
Belanda	NLTK
Rancah	Kebi
Madar	Kebi
Tumpeng	Kebi
Piedmont	NLTK
Cengkok	Kebi
Kampak	Kebi
Kedak	Kebi
Gera	Kebi
Waur	NLTK
Marang	NLTK
Renteng	Kebi
Pengkol	Kebi
Bae	NLTK
Jemparing	Kebi
Padang	Kebi
Birang	Kebi
Keras	Kebi
Natal	Kebi
Kabar	Kebi
Suangi	Kebi
Gedebeg	Kebi
Sawah	Kebi
Geplak	Kebi
Praya	NLTK
Bambu	Kebi
Sabah	Kebi
Leu	NLTK
Sapa	Kebi
Kabat	Kebi
Gaga	Kebi
Kotes	Kebi
Subur	Kebi
Dara	Kebi
Tapuk	Kebi
Moyang	Kebi
Pangkur	Kebi
Kecik	Kebi
Lantan	Kebi
Kuta	Kebi
Lembur	Kebi
Swiss	NLTK
Kendit	Kebi
Kanan	Kebi
Abuan	Kebi
Burai	Kebi
Tone	NLTK
Sia	Kebi
Sungkap	Kebi
Tapus	Kebi
Ara	Kebi
Sogan	Kebi
Babad	Kebi
Wellington	NLTK
Semambu	Kebi
Pane	NLTK
Tuk	Kebi
Katurai	NLTK
Lesa	Kebi
Tepus	Kebi
Pancang	Kebi
Bahagia	Kebi
Taluk	NLTK
Bila	Kebi
Daya	Kebi
Latung	Kebi
Bancak	Kebi
Harus	Kebi
Gadang	Kebi
Ganal	Kebi
Tenggayun	Kebi
Kabir	Kebi
Dolok	Kebi
Kenanga	Kebi
Pollard	NLTK
Aha	NLTK
Cengkir	Kebi
Bulian	Kebi
Jemur	Kebi
Atok	Kebi
Amen	Kebi
Mico	NLTK
Kopi	Kebi
Bidara	Kebi
Demit	Kebi
Minggir	Kebi
Buru	Kebi
Pingit	Kebi
Jengkol	Kebi
Jangkat	Kebi
Bunder	Kebi
Naga	Kebi
Baung	Kebi
Lingga	Kebi
Lestari	Kebi
Terban	Kebi
Kelun	Kebi
Laksana	Kebi
Tarau	NLTK
Sigi	Kebi
Sudi	Kebi
Barcelona	NLTK
Beruk	Kebi
Bagan	Kebi
Dah	Kebi
Mesjid	Kebi
Sotol	NLTK
Tumpu	Kebi
Bala	Kebi
Jambon	Kebi
Dander	NLTK
Bulu	Kebi
Badung	Kebi
Mire	NLTK
Kakas	Kebi
Bara	Kebi
Sambangan	Kebi
Capar	Kebi
Entak	Kebi
Taulan	Kebi
Bentang	Kebi
Sirap	Kebi
Kurau	Kebi
Poly	NLTK
Tanduk	Kebi
Kembang	Kebi
Bodi	Kebi
Ubung	Kebi
Punggur	Kebi
Jembrana	Kebi
Landak	Kebi
Keroncong	Kebi
Soka	Kebi
Taupo	NLTK
Mungkur	Kebi
Kuncir	Kebi
Regol	Kebi
Gebang	Kebi
Dakar	Kebi
Bukit	Kebi
Kupur	Kebi
Laju	Kebi
Bogor	Kebi
Siding	Kebi
Lorong	Kebi
Sampurna	Kebi
Belandang	Kebi
Gadon	Kebi
Loka	Kebi
Beru	Kebi
Rengat	Kebi
Menggala	Kebi
Kelor	Kebi
Kukuh	Kebi
Kepuh	Kebi
Liang	Kebi
Flagstaff	NLTK
Langkat	Kebi
Konstantin	NLTK
Tutup	Kebi
Ketol	NLTK
Pudi	Kebi
Sajen	Kebi
Figur	Kebi
Mir	NLTK
Tembuku	Kebi
Ain	Kebi
Mali	NLTK
Tengah	Kebi
Giling	Kebi
Bilo	NLTK
Menur	Kebi
Dempet	Kebi
Kundi	Kebi
Mambo	Kebi
Kia	Kebi
Urung	Kebi
Gembor	Kebi
Mandung	Kebi
Khatulistiwa	Kebi
Police	NLTK
Padi	Kebi
Juli	Nama bulan
Patuk	Kebi
Kampil	Kebi
Bacin	Kebi
Tebing	Kebi
Guha	Kebi
Muser	NLTK
Istiqlal	Kebi
Boros	Kebi
Langkan	Kebi
Kasai	Kebi
Onycha	NLTK
Perangai	Kebi
Babatan	Kebi
Puring	Kebi
Babai	NLTK
Concord	NLTK
Langse	Kebi
Pakal	Kebi
Satria	Kebi
Gelombang	Kebi
Ponggang	Kebi
Coper	NLTK
Balai-balai	Kebi
Telempong	Kebi
Granada	NLTK
Katul	Kebi
Punjung	Kebi
Rendeng	Kebi
Soya	NLTK
Goyang	Kebi
Topang	Kebi
Bakam	Kebi
Sirih	Kebi
Panau	Kebi
Sabang	Kebi
Mekar	Kebi
Sayang	Kebi
Teratai	Kebi
Pau	NLTK
Gedang	Kebi
Kasuari	Kebi
Budur	Kebi
Purana	NLTK
Kelubi	Kebi
Rongga	Kebi
Ranah	Kebi
Lame	NLTK
Boto	Kebi
Samson	NLTK
Bulak	Kebi
Colima	NLTK
Kaleng	Kebi
Sewu	Kebi
Asem	NLTK
Kapi	Kebi
Random	NLTK
Lindu	Kebi
Betung	Kebi
Patas	NLTK
Tipar	Kebi
Semata	Kebi
Birahi	Kebi
Bunglai	Kebi
Mendung	Kebi
Bonjol	Kebi
Longok	Kebi
Bange	NLTK
Langut	Kebi
Berembang	Kebi
Terak	Kebi
Belitung	Kebi
Tampang	Kebi
Padasan	Kebi
Luhak	Kebi
Biga	NLTK
Midway	NLTK
Gerendeng	Kebi
Keper	Kebi
Sinoman	Kebi
Perepat	Kebi
Berdikari	Kebi
Balung	Kebi
Mandau	Kebi
Wenang	Kebi
Utama	Kebi
Pering	Kebi
Krecek	Kebi
Gamping	Kebi
Diat	Kebi
Dwiwarna	Kebi
Telaga	Kebi
Benua	Kebi
Tanjung	Kebi
Pangi	NLTK
Rinding	Kebi
Punti	Kebi
Sendang	Kebi
Muara	Kebi
Layap	Kebi
Pasting	NLTK
Warangan	Kebi
Pikat	Kebi
Padan	Kebi
Oyak	Kebi
Waris	Kebi
Belendung	Kebi
Hale	NLTK
Pule	NLTK
Pupus	Kebi
Lumbu	Kebi
Sementara	Kebi
Sapat	Kebi
Bocor	Kebi
Kesek	Kebi
Simpur	Kebi
Bagor	Kebi
Pesisir	Kebi
Baluk	Kebi
Redang	Kebi
Limun	Kebi
Ranggas	Kebi
Kiara	Kebi
Buntet	Kebi
Ungkal	Kebi
Gemuruh	Kebi
Baharu	Kebi
Belimbing	Kebi
Panas	Kebi
Tapa	Kebi
Selesai	Kebi
Wasiat	Kebi
Watu	Kebi
Wajik	Kebi
Cangkring	Kebi
Roi	Kebi
Tangen	Kebi
Rembang	Kebi
Pelanduk	Kebi
Teter	Kebi
Gelugur	Kebi
Celep	Kebi
Batung	Kebi
Rite	NLTK
Midar	Kebi
Bayem	Kebi
Nau	Kebi
Kedah	Kebi
Luk	Kebi
Tapir	Kebi
Tenggiling	Kebi
Kalembak	Kebi
Ratu	Kebi
Mandor	Kebi
Roman	Kebi
Arus	Kebi
Adiraja	Kebi
Aguinaldo	NLTK
Tukak	Kebi
Pana	Kebi
Kelesa	Kebi
Tangkas	Kebi
Pedes	NLTK
Lawa	Kebi
Banjaran	Kebi
Lawang	Kebi
Lebak	Kebi
Muhajirin	Kebi
Jantuk	Kebi
Berkas	Kebi
Besar	Kebi
Banget	Kebi
Keramat	Kebi
Kersik	Kebi
Bale	NLTK
Pudu	NLTK
Cekalang	Kebi
Kabil	Kebi
Lirik	Kebi
Jajar	Kebi
Langgar	Kebi
Tulis	Kebi
Kupang	Kebi
Langgeng	Kebi
Suluk	Kebi
Putih	Kebi
Petang	Kebi
Balian	Kebi
Sengkuang	Kebi
Kelambir	Kebi
Lintang	Kebi
Pace	Kebi
Sintuk	Kebi
Yayasan	Kebi
Demung	Kebi
Apalit	NLTK
Bolong	Kebi
Aruk	Kebi
Karo	NLTK
Pontianak	NLTK
Benuang	Kebi
Beluk	Kebi
Pallette	NLTK
Kasui	Kebi
Rawa	Kebi
Windu	Kebi
Metro	Kebi
Kubu	Kebi
Mila	NLTK
Kesongo	Kebi
Jukung	Kebi
Jenang	Kebi
Tapak	Kebi
Tempuling	Kebi
Alma	NLTK
Agung	Kebi
Gunung	Kebi
Tuju	Kebi
Jojol	Kebi
Lekok	Kebi
Karau	Kebi
Limbur	Kebi
Lantik	Kebi
Madukara	Kebi
Upau	Kebi
Petir	Kebi
Dorang	Kebi
Widuri	Kebi
Rawi	Kebi
Gadungan	Kebi
Borong	Kebi
Soso	NLTK
Rimbun	Kebi
II	romawi
Haus	Kebi
Kanara	NLTK
Banda	Kebi
Kasmaran	Kebi
Lai	Kebi
Capang	Kebi
Debut	Kebi
Bakal	Kebi
Baran	Kebi
Panda	NLTK
Susuk	Kebi
Lambur	Kebi
Jambar	Kebi
Pecuk	Kebi
Balai	Kebi
Bido	Kebi
Para	Kebi
Semanak	Kebi
Kuala	Kebi
Dompak	Kebi
Kabul	Kebi
Boya	Kebi
Semut	Kebi
Merpati	Kebi
Kencana	Kebi
Beting	Kebi
Candung	Kebi
Antara	Kebi
Lulut	Kebi
Dampit	Kebi
Malo	NLTK
Tungkap	Kebi
Badang	Kebi
Bayu	Kebi
Kopek	Kebi
Rum	Kebi
Cangak	Kebi
Gembol	Kebi
Perigi	Kebi
Angsana	Kebi
Colony	NLTK
Kedongdong	Kebi
Barangan	Kebi
Gunawan	Kebi
Siluman	Kebi
Bagang	Kebi
Kendayakan	Kebi
Merak	Kebi
Sambit	Kebi
Rengas	Kebi
Runding	Kebi
Periuk	Kebi
Ledang	Kebi
Bungur	Kebi
Sambung	Kebi
Tumbuk	Kebi
Meninting	NLTK
Tipes	Kebi
Kawak	Kebi
Gampang	Kebi
Cantel	Kebi
Tuntun	Kebi
Argo	NLTK
Manunggal	Kebi
Lahar	Kebi
Penghulu	Kebi
Kenyam	Kebi
Ganding	Kebi
Panama	NLTK
Munjung	Kebi
Munggu	Kebi
Suli	Kebi
Botok	Kebi
Bika	Kebi
Ladan	Kebi
Bukat	Kebi
Latak	Kebi
Amman	NLTK
Pai	Kebi
Cinta	Kebi
Kemloko	Kebi
Poma	Kebi
Dorman	Kebi
Pasung	Kebi
Bago	NLTK
Lewa	Kebi
Palang	Kebi
Kidal	Kebi
Parado	NLTK
Gurah	Kebi
Tarn	NLTK
Sadu	Kebi
Poleng	Kebi
Tenggarang	Kebi
Batakan	NLTK
Lemon	Kebi
Pemuda	Kebi
Karuan	Kebi
Sipi	Kebi
Obi	Kebi
Tuwung	Kebi
Ponto	NLTK
Kapit	Kebi
Panembahan	Kebi
Pasteur	Kebi
Dairi	NLTK
Koja	Kebi
Buang	Kebi
Paten	Kebi
Lumut	Kebi
Olak	Kebi
Semen	Kebi
Barang	Kebi
Jenggot	Kebi
Pedada	Kebi
Moga	Kebi
Siantan	Kebi
Toro	Kebi
Belanga	Kebi
Ketupat	Kebi
Pancur	Kebi
Amis	Kebi
Beku	Kebi
Alim	Kebi
Burat	Kebi
Terjun	Kebi
Samping	Kebi
Lantung	Kebi
Beo	Kebi
Jompo	Kebi
Bantaran	Kebi
Paser	Kebi
Setren	Kebi
Silo	Kebi
Tapin	Kebi
Patik	Kebi
Baya	Kebi
Salang	Kebi
Urai	Kebi
Tamboo	NLTK
Batok	Kebi
Kapling	Kebi
Bran	NLTK
Bajak	Kebi
Pergam	Kebi
Tenda	Kebi
Bintan	Kebi
Rembes	Kebi
Kawan	Kebi
Pari	Kebi
Kundur	Kebi
Garut	Kebi
Riam	Kebi
Muncang	Kebi
Mindi	Kebi
Condong	Kebi
Jambu	Kebi
Bahara	Kebi
Ban	Kebi
Sentul	Kebi
Lumbung	Kebi
Keting	Kebi
Talun	Kebi
Begal	Kebi
Danau	Kebi
Barat	Kebi
Bunter	NLTK
Trimurti	Kebi
Jemah	Kebi
Tambak	Kebi
Pabean	Kebi
Kesuma	Kebi
Keling	Kebi
Panjang	Kebi
Wab	NLTK
Wadas	Kebi
Porong	Kebi
Data	Kebi
Peron	Kebi
Ganti	Kebi
Rangkang	Kebi
Temu	Kebi
Tempel	Kebi
Tinggi	Kebi
Balang	Kebi
Ketip	Kebi
Weaver	NLTK
Situ	Kebi
Tatar	Kebi
Bambang	Kebi
Pasar	Kebi
Ganting	Kebi
Duku	Kebi
Bokor	Kebi
Jontor	Kebi
Bengkak	Kebi
Sea	NLTK
Ibul	Kebi
Telak	Kebi
Sahan	Kebi
Aras	Kebi
Lontar	Kebi
Klitik	Kebi
Jeruk	Kebi
Manila	Kebi
Iba	Kebi
Sumbang	Kebi
Lenda	Kebi
Bola	Kebi
Jambak	Kebi
Bergas	Kebi
Jagaraga	Kebi
Mirat	Kebi
Lesah	Kebi
Minter	NLTK
Asmara	Kebi
Lagan	Kebi
Janjang	Kebi
Manuk	Kebi
Kelapa	Kebi
Butuh	Kebi
Sulu	Kebi
Dedai	Kebi
Semangat	Kebi
Waru	Kebi
Kurma	Kebi
Gambut	Kebi
Waer	NLTK
Sagu	Kebi
Panggung	Kebi
Malati	NLTK
Busung	Kebi
Bundar	Kebi
Mura	Kebi
Juhut	Kebi
Pekaja	Kebi
Kedasih	Kebi
Danger	NLTK
Merah	Kebi
Gondang	NLTK
Pagelaran	Kebi
Hayo	Kebi
Jangkung	Kebi
Jotang	Kebi
Bajing	Kebi
Butler	NLTK
Ibra	Kebi
Tumbal	Kebi
Singkir	Kebi
Jagur	Kebi
Tumu	Kebi
Waduk	Kebi
Cupak	Kebi
Tering	Kebi
Parang	Kebi
Taler	NLTK
Rau	Kebi
Essang	NLTK
Tengguli	Kebi
Tales	NLTK
Gunting	Kebi
Kopong	Kebi
Pematang	Kebi
Gudang	Kebi
Pujut	Kebi
Ajung	Kebi
Swadaya	Kebi
Pinding	Kebi
Malaka	Kebi
Cungkup	Kebi
Natar	Kebi
Dalung	Kebi
Sumilir	Kebi
Serasi	Kebi
Michigan	NLTK
Rengkam	Kebi
Lili	Kebi
Atas	Kebi
Lampok	Kebi
Reban	Kebi
Guli	Kebi
Pager	NLTK
Tebuk	Kebi
Balong	Kebi
Tangun	NLTK
Palolo	Kebi
Bayan	Kebi
Baras	Kebi
Berok	Kebi
Tukang	Kebi
Dangka	Kebi
Kendaga	Kebi
Awang	Kebi
Polan	Kebi
Kerik	Kebi
Wanga	NLTK
Jorok	Kebi
Karas	Kebi
Jangkang	Kebi
Kubang	Kebi
Paradise	NLTK
Ulang	Kebi
Serut	Kebi
Gelanggang	Kebi
Dedap	Kebi
Vina	NLTK
Jagabaya	Kebi
Payung	Kebi
Perwira	Kebi
Singa	Kebi
Kuang	Kebi
Tule	Kebi
Benda	Kebi
Betara	Kebi
Mas	Kebi
Raharja	Kebi
Murni	Kebi
Patung	Kebi
Semanggi	Kebi
Cabak	Kebi
Surian	Kebi
Kedaung	Kebi
Bulu-bulu	Kebi
Gandaria	Kebi
Lebang	Kebi
Gabus	Kebi
Jernih	Kebi
Kuningan	Kebi
Cempa	Kebi
Palam	Kebi
Conto	NLTK
Tual	Kebi
Maja	Kebi
Sejati	Kebi
Loleng	Kebi
Nagasari	Kebi
Pusu	Kebi
Blimbing	NLTK
Kala	Kebi
Loke	NLTK
Pagu	Kebi
Sasi	Kebi
Sapit	Kebi
Kebur	Kebi
Daleman	NLTK
Bagak	Kebi
Sampean	Kebi
Padas	Kebi
Belang	Kebi
Suruh	Kebi
Serdang	Kebi
Anggai	Kebi
Balak	Kebi
Sedang	Kebi
Gombang	Kebi
Wirang	Kebi
Duren	Kebi
Masrum	Kebi
Betet	Kebi
Sangau	Kebi
Uling	Kebi
Sukur	Kebi
Seberang	Kebi
Brad	NLTK
Purus	Kebi
Bareng	Kebi
Kedung	Kebi
Tunjung	Kebi
Manyar	Kebi
Mary	NLTK
Burka	NLTK
Paris	Kebi
Tamban	Kebi
Ibu	Kebi
Monggol	Kebi
Doyong	Kebi
Garangan	Kebi
Sawai	Kebi
Utara	Kebi
Banteng	Kebi
Datar	Kebi
Sono	Kebi
Pelang	Kebi
Bone	NLTK
Sela	Kebi
Serbaguna	Kebi
Leban	Kebi
Tes	Kebi
Keliki	Kebi
Bongkot	Kebi
Lumbang	NLTK
Hastings	NLTK
Tumpuk	Kebi
Golok	Kebi
Mawar	Kebi
Letung	Kebi
Telang	Kebi
Pandang	Kebi
Ruan	Kebi
Mendut	Kebi
Tilang	Kebi
Bangsal	Kebi
Pulau	Kebi
Semangkok	Kebi
Bungkuk	Kebi
Bau	Kebi
Glodok	Kebi
Sepan	Kebi
Nasal	Kebi
Mala	Kebi
Ascension	NLTK
Bane	NLTK
Roka	NLTK
Tripoli	NLTK
Salur	Kebi
Gerit	Kebi
Lanca	Kebi
Dadi	Kebi
Ambon	NLTK
Keburu	Kebi
Sumbul	Kebi
Kendung	Kebi
Kano	Kebi
Lego	Kebi
Langir	Kebi
Genteng	Kebi
Pintu	Kebi
Sejoli	Kebi
Kricak	Kebi
Loyang	Kebi
Belat	Kebi
Getas	Kebi
Kalang	Kebi
Tawar	Kebi
Saba	Kebi
Gayam	Kebi
Atap	Kebi
Empus	Kebi
Terentang	Kebi
Kasang	Kebi
Oma	Kebi
Juang	Kebi
Baban	Kebi
Mamut	Kebi
Bero	Kebi
Karah	Kebi
Gambir	Kebi
Sekunyit	Kebi
Kepung	Kebi
Pekojan	Kebi
Pakuncen	Kebi
Pino	NLTK
Kayang	Kebi
Belok	Kebi
Kunci	Kebi
Turi	Kebi
Koreng	Kebi
Kahu	NLTK
Solokan	Kebi
Gemah	Kebi
Ur	NLTK
Denai	Kebi
Jejawi	Kebi
Bangsa	Kebi
Bonjor	Kebi
Morella	NLTK
Teratak	Kebi
Rantau	Kebi
Gu	Kebi
Gantung	Kebi
Holi	Kebi
Swakarya	Kebi
Saka	Kebi
Cangkir	Kebi
Nectar	NLTK
Tugu	Kebi
Sanjai	Kebi
Balad	Kebi
Simpang	Kebi
Beruas	Kebi
Perincit	Kebi
Lancang	Kebi
Les	Kebi
Semaya	Kebi
Belian	Kebi
Garong	Kebi
Tajen	Kebi
Birit	Kebi
Gobo	NLTK
Bender	NLTK
Bangai	Kebi
Tiris	Kebi
Sindon	NLTK
Kucur	Kebi
Kelong	Kebi
Penjalin	Kebi
Procot	Kebi
Kopah	Kebi
Samsam	Kebi
Kanjar	Kebi
Rabat	Kebi
Lea	NLTK
Kapur	Kebi
Elok	Kebi
Mendak	Kebi
Soba	Kebi
Panjer	Kebi
Kujung	Kebi
Lampar	Kebi
West	NLTK
Turus	Kebi
Kuwu	Kebi
Kusu	Kebi
Leighton	NLTK
Lempuyang	Kebi
Semarum	NLTK
Tampan	Kebi
Grave	NLTK
Lombok	Kebi
Comal	NLTK
Langkap	Kebi
Mewek	Kebi
Bilal	Kebi
Rendang	Kebi
Banding	Kebi
Wara	Kebi
Langi	Kebi
Licin	Kebi
Delft	NLTK
Kecapi	Kebi
Manjung	Kebi
Kajen	Kebi
Duru	Kebi
Anchorage	NLTK
Sampak	Kebi
Terung	Kebi
Bais	Kebi
Batang	Kebi
Rua	Kebi
Bataan	NLTK
Badak	Kebi
Tandun	Kebi
Tenam	Kebi
Lembang	Kebi
Anyar	Kebi
Tepos	Kebi
Berat	Kebi
Pelawa	Kebi
Dupak	Kebi
Mome	NLTK
Kantin	Kebi
Selong	Kebi
Kedok	Kebi
Rambah	Kebi
Boro	NLTK
Gelap	Kebi
Normal	Kebi
Bunga	Kebi
Agam	Kebi
Ringin	Kebi
Snead	NLTK
Jombang	Kebi
Tegak	Kebi
Soe	Kebi
Gerunggung	Kebi
Kinantan	Kebi
Damai	Kebi
Wantilan	Kebi
Dompol	Kebi
Kacapiring	Kebi
Bendahara	Kebi
Sanya	Kebi
Bebel	Kebi
Ungu	Kebi
Momo	NLTK
Bedrug	NLTK
Lembah	Kebi
Dalang	Kebi
Intan	Kebi
Lais	Kebi
Tulung	Kebi
Jumrah	Kebi
Westland	NLTK
Beka	Kebi
Keton	Kebi
Maru	Kebi
Ranggeh	Kebi
Lima	Kebi
Bonder	NLTK
Brent	NLTK
Tempayung	Kebi
Laba	Kebi
Gerogol	Kebi
Samir	Kebi
Rintik	Kebi
Lasi	Kebi
Bagi	Kebi
Sambi	Kebi
Kudus	Kebi
Pianggu	Kebi
Sidamukti	Kebi
Nyalang	Kebi
Pelaga	Kebi
Sarangan	Kebi
Darunu	Kebi
Kuning	Kebi
Mambang	Kebi
Kemang	Kebi
Paran	Kebi
Kapita	Kebi
Wayang	Kebi
Jangka	Kebi
Teriak	Kebi
Bantar	Kebi
Menara	Kebi
Tandu	Kebi
Paku	Kebi
Usul	Kebi
Bolivia	NLTK
Weton	Kebi
Pantar	Kebi
Pesantren	Kebi
Pao-Pao	Kebi
Kias	Kebi
Sucre	NLTK
Kampung	Kebi
Manggung	Kebi
Lija	NLTK
Loa	NLTK
Pada	Kebi
Needles	NLTK
Terkul	Kebi
Black	NLTK
Gelong	NLTK
Maria	Kebi
Bercak	Kebi
Pedang	Kebi
Solo	Kebi
Sundul	Kebi
Parit	Kebi
Pauh	Kebi
Samudera	Kebi
Gemulung	Kebi
Jerambang	Kebi
Aplasi	Kebi
Kepundung	Kebi
Passo	NLTK
Lara	Kebi
Pakis	Kebi
Setia	Kebi
Gaum	NLTK
Kapal	Kebi
Solok	Kebi
Pencil	Kebi
Jelantik	Kebi
Buntu	Kebi
Bajang	Kebi
Koto	NLTK
Hulu	Kebi
Keli	Kebi
Kunir	Kebi
Ronta	Kebi
Etna	NLTK
Kokosan	Kebi
Wedani	Kebi
Awan	Kebi
Jelai	Kebi
Saban	Kebi
Wadung	Kebi
Waringin	Kebi
Cukir	Kebi
Nipa	NLTK
Bangkok	NLTK
Awar-awar	Kebi
Sawangan	Kebi
Whetstone	NLTK
Sampang	Kebi
Langgai	Kebi
Legok	Kebi
Bongo	Kebi
Mentor	Kebi
Kemuning	Kebi
Suci	Kebi
Leduk	Kebi
Terik	Kebi
Arc	NLTK
Keriting	Kebi
Gelang	Kebi
Keluang	Kebi
Badau	Kebi
Jagapati	Kebi
Pencong	Kebi
Tobang	Kebi
Laura	NLTK
Geliting	Kebi
Taupe	NLTK
Medan	Kebi
Ajang	Kebi
Bulan	Kebi
Colorado	NLTK
Karya	Kebi
Limpung	Kebi
Dalam	Kebi
Longa	NLTK
Mayang	Kebi
Galih	Kebi
Cerih	Kebi
Kara	Kebi
Wain	NLTK
Surrey	NLTK
Timbang	Kebi
Cupang	Kebi
Pedak	Kebi
Tambung	Kebi
Rasau	Kebi
Eban	Kebi
Balau	Kebi
Kecipir	Kebi
Jagir	NLTK
Hum	NLTK
Gambia	NLTK
Sambet	Kebi
Gilang	Kebi
Beloh	Kebi
Pondoh	Kebi
Apung	Kebi
Limbung	Kebi
Ponggok	Kebi
Waled	NLTK
Wora-Wari	Kebi
Gereneng	Kebi
Sumsum	Kebi
Gumuk	Kebi
Mertelu	Kebi
Amang	Kebi
Bunton	NLTK
Derik	Kebi
Bermi	Kebi
Jangkar	Kebi
Sepang	Kebi
Pacar	Kebi
Panorama	Kebi
Maki	Kebi
Ancol	Kebi
Teladan	Kebi
Talang	Kebi
Maman	Kebi
Cawan	Kebi
Ringgit	Kebi
Gumul	Kebi
Kendal	Kebi
Gerih	Kebi
Bendo	Kebi
Kondang	Kebi
Pantai	Kebi
Kacung	Kebi
Lempang	Kebi
Tajur	Kebi
Salut	Kebi
Lanjuk	Kebi
Gawang	Kebi
Guguk	Kebi
Tutur	Kebi
Sigando	Kebi
Bengkayang	Kebi
Kokas	Kebi
Gedong	Kebi
Tutung	Kebi
Menteng	Kebi
Juba	NLTK
Mungguk	Kebi
Marga	Kebi
Union	Kebi
Dorong	Kebi
Bangkir	Kebi
Punjul	Kebi
Pesing	Kebi
Ladang	Kebi
Bayat	Kebi
Mandai	Kebi
Pahlawan	Kebi
Lembar	Kebi
Cendana	Kebi
Apar	Kebi
Wali	Kebi
Koli	Kebi
Beha	Kebi
Sire	NLTK
Bandongan	Kebi
Kurun	Kebi
Lobang	Kebi
Suren	Kebi
Cekel	Kebi
Kelumpang	Kebi
Abang	Kebi
Muda	Kebi
Randu	Kebi
Kepayang	Kebi
Mustika	Kebi
Rintis	Kebi
Bandul	Kebi
Rangsang	Kebi
Rahayu	Kebi
Susup	Kebi
Ibun	Kebi
Bata	Kebi
Kepoh	Kebi
Topo	Kebi
Bangkal	Kebi
Siring	Kebi
Sanca	Kebi
Kore	NLTK
Sepit	Kebi
Pacul	Kebi
Mojo	NLTK
Boden	NLTK
Kasturi	Kebi
Hanjuang	Kebi
Pulung	Kebi
Tepas	Kebi
Kanang	Kebi
Banglas	Kebi
Tangkis	Kebi
Gardu	Kebi
Ketapang	Kebi
Bakti	Kebi
Butun	Kebi
Mampu	Kebi
Junjung	Kebi
Selo	Kebi
Kolor	Kebi
Bokong	Kebi
Sukun	Kebi
Salap	Kebi
Bintang	Kebi
Angkasa	Kebi
Sini	Kebi
Bakau	Kebi
Lee	NLTK
Srigading	Kebi
Kesambi	Kebi
Mangga	Kebi
Pati	Kebi
Biau	Kebi
Manis	Kebi
Jatuh	Kebi
Oreng	Kebi
Timbau	Kebi
Tritunggal	Kebi
Kosar	Kebi
Lembung	Kebi
Kasih	Kebi
Sadah	Kebi
Tapung	Kebi
Sungsum	Kebi
Soban	Kebi
Terap	Kebi
Palu	Kebi
Brosot	NLTK
Paking	Kebi
Guinea	NLTK
Juragan	Kebi
Bumbung	Kebi
Alai	Kebi
Taras	Kebi
Mujur	Kebi
Tekung	Kebi
Muna	Kebi
Kates	Kebi
Nelayan	Kebi
Joglo	Kebi
Motto	NLTK
Dukun	Kebi
Moho	NLTK
Kaso	Kebi
Peta	Kebi
Bancang	Kebi
Durian	Kebi
Tembuni	Kebi
Wau	Kebi
Kumbang	Kebi
Ruji	Kebi
Banjang	Kebi
Buyut	Kebi
Tope	NLTK
Bengkawan	Kebi
Setabelan	Kebi
Goa	NLTK
Lambak	Kebi
Ampel	Kebi
Newton	Kebi
Selat	Kebi
Jurit	Kebi
Seko	Kebi
Lumpang	Kebi
Bandung	Kebi
Gentong	Kebi
Prasi	Kebi
Bakung	Kebi
Tomang	Kebi
Namun	Kebi
Seling	Kebi
Bubuk	Kebi
Moyo	NLTK
Sengon	Kebi
Kepuk	Kebi
Bengkol	Kebi
Tebas	Kebi
Gancang	Kebi
Dirgahayu	Kebi
Mini	Kebi
Tulang	Kebi
Neath	NLTK
Deram	Kebi
Sedari	Kebi
Daun	Kebi
Tiram	Kebi
Medali	Kebi
Kepek	Kebi
Garu	Kebi
Hilir	Kebi
Sembung	Kebi
Ambal	Kebi
Lapang	Kebi
Batu	Kebi
Serot	Kebi
Gelung	Kebi
Panggih	Kebi
Jamu	Kebi
Sekoci	Kebi
Tura	Kebi
Titik	Kebi
Sering	Kebi
Kempas	Kebi
Mutiara	Kebi
Sedan	Kebi
Bayang	Kebi
Bende	Kebi
Lenteng	Kebi
Limpas	Kebi
Galung	Kebi
Jongkang	Kebi
Bujang	Kebi
Rangda	Kebi
Badal	Kebi
Sawan	Kebi
Perak	Kebi
Gantang	Kebi
Rasi	Kebi
Bengkal	Kebi
Ambit	NLTK
Pasanggrahan	Kebi
Mengok	Kebi
Buntar	Kebi
Dame	Kebi
Kulur	Kebi
Belu	Kebi
Karang	Kebi
Perupuk	Kebi
Gadung	Kebi
Lebih	Kebi
Terumbu	Kebi
Naning	Kebi
Wage	NLTK
Santing	Kebi
Puri	Kebi
Payu	Kebi
Bubun	Kebi
Bedoyo	NLTK
Lulu	NLTK
Singkup	Kebi
Bulus	Kebi
Kuripan	Kebi
Tampung	Kebi
Kemamang	Kebi
Balen	Kebi
Petak	Kebi
Rantang	Kebi
Pukul	Kebi
Kawal	Kebi
Boke	NLTK
Peso	NLTK
Kalis	Kebi
Tamak	Kebi
Glee	NLTK
Muai	Kebi
Boston	NLTK
Sambau	Kebi
Aire	NLTK
Bulangan	Kebi
Keraton	Kebi
Rabak	Kebi
Bentar	Kebi
Muskat	NLTK
Kujang	Kebi
Belik	Kebi
Kunduran	Kebi
Bendung	Kebi
Onto	NLTK
Degan	Kebi
Bunut	Kebi
Pola	Kebi
Galur	Kebi
Bungo	NLTK
Akbar	Kebi
Nadi	Kebi
Janji	Kebi
Mancung	Kebi
Islam	Kebi
Tumang	Kebi
Rangas	Kebi
Gersik	Kebi
Tabir	Kebi
Jasa	Kebi
Negara	Kebi
Heath	NLTK
Kemumu	Kebi
Walikukun	Kebi
Jenawi	Kebi
Pilang	Kebi
Kapu	Kebi
Dasun	Kebi
Puput	Kebi
Poring	NLTK
Taruko	Kebi
Bo	NLTK
Dewi	Kebi
Kumpi	Kebi
Madu	Kebi
Kuli	Kebi
Musi	Kebi
Kelabat	Kebi
Temiang	Kebi
Ender	NLTK
Jumeneng	Kebi
Aba	Kebi
Tunjuk	Kebi
Singkil	Kebi
Tangsi	Kebi
Mampai	Kebi
Kilo	Kebi
Pinang	Kebi
Tuban	Kebi
Rawang	Kebi
Mulur	Kebi
Belah	Kebi
Nibung	Kebi
Jenu	Kebi
Polen	Kebi
Sumo	Kebi
Pacet	Kebi
Sumber	Kebi
Karakul	NLTK
Sayung	Kebi
Nampan	Kebi
Meger	Kebi
Kepudang	Kebi
Genting	Kebi
Jelutung	Kebi
Monggo	Kebi
Trepan	NLTK
Pelita	Kebi
Darma	Kebi
Poso	Kebi
Seminai	Kebi
Paga	NLTK
Sima	NLTK
Jeli	Kebi
Taat	Kebi
Arara	NLTK
Tabet	NLTK
Astana	Kebi
Lori	Kebi
Kalumpang	NLTK
Kedai	Kebi
Guci	Kebi
Jaman	Kebi
Lio	Kebi
Mayung	Kebi
Gandu	Kebi
Sine	NLTK
Ayah	Kebi
Pesa	Kebi
Jurung	Kebi
Unity	NLTK
Mungkin	Kebi
Gembong	Kebi
Kesik	Kebi
Ukir	Kebi
Cowek	Kebi
Singgit	Kebi
Tangga	Kebi
Manggis	Kebi
Binjai	Kebi
Alak	Kebi
Rian	Kebi
Firdaus	Kebi
Kona	NLTK
Sedeng	Kebi
Kumai	Kebi
Tambakan	Kebi
Kembu	Kebi
Penjuru	Kebi
Puguh	Kebi
Rumbia	Kebi
Pahang	Kebi
Nibong	NLTK
Bungkal	Kebi
Merdeka	Kebi
Mare	Kebi
Bean	NLTK
Mereng	Kebi
Semat	Kebi
Kasihan	Kebi
Pandu	Kebi
Riung	Kebi
Keman	Kebi
Ganggang	Kebi
Mundam	Kebi
Tumpak	Kebi
Gaung	Kebi
Sakti	Kebi
Jebol	Kebi
Pepe	Kebi
Dow	NLTK
Paron	Kebi
Catur	Kebi
Lemo	Kebi
Temalang	Kebi
Bintara	Kebi
Matur	Kebi
Duwet	Kebi
Candi	Kebi
Kemu	Kebi
Rejasa	Kebi
Boba	NLTK
Banjar	Kebi
Saptamarga	Kebi
Penaga	Kebi
Bangun	Kebi
Pemali	Kebi
Paren	NLTK
Merambung	Kebi
Umu	Kebi
Pucuk	Kebi
Kuncen	Kebi
Tobat	Kebi
Sangku	Kebi
Pangkat	Kebi
Gandasuli	Kebi
Tempur	Kebi
Kuku	Kebi
Tarub	Kebi
Selang	Kebi
Tenggak	Kebi
Embacang	Kebi
Keji	Kebi
Tangki	Kebi
Suka	Kebi
Weri	NLTK
Taring	Kebi
Basoka	Kebi
Kudu	Kebi
Sanding	Kebi
Magersari	Kebi
Besuk	Kebi
Geger	Kebi
Utan	Kebi
Salem	Kebi
Kolong	Kebi
Lengking	Kebi
Kitang	Kebi
Mandiri	Kebi
Dulang	Kebi
Bahari	Kebi
Tutul	Kebi
Meranti	Kebi
Rakit	Kebi
Denok	Kebi
Raya	Kebi
Kupu	Kebi
Basin	Kebi
Simbang	Kebi
Teras	Kebi
Hidalgo	NLTK
Lengkong	Kebi
Jake	NLTK
Eclectic	NLTK
Tihang	Kebi
Cangkang	Kebi
Kupa	Kebi
Ternate	NLTK
Japan	NLTK
Rahmat	Kebi
Igal	Kebi
Legundi	Kebi
Sembilang	Kebi
Babakan	Kebi
Lele	Kebi
Beber	Kebi
Umbu	Kebi
Arusha	NLTK
Makam	Kebi
Purnama	Kebi
Runggu	Kebi
Belawan	Kebi
Ujang	Kebi
Api-Api	Kebi
Ratas	Kebi
Ilu	Kebi
Beri	Kebi
Gajah	Kebi
Kentong	Kebi
Sarang	Kebi
Puser	Kebi
Ampang	Kebi
Panti	Kebi
Rumbai	Kebi
Kodak	Kebi
Malang	Kebi
Silam	Kebi
Ujung	Kebi
Madat	Kebi
Akas	Kebi
Geneva	NLTK
Luar	Kebi
Alur	Kebi
Kemiri	Kebi
Toga	Kebi
Taar	NLTK
Jumput	Kebi
Tanjong	NLTK
Wulung	Kebi
Tarok	NLTK
Bangka	Kebi
Sereh	Kebi
Lepak	Kebi
Teluk	Kebi
Sauk	Kebi
Ramania	Kebi
Allgood	NLTK
Gading	Kebi
Dandang	Kebi
Bonto	Kebi
Kolot	Kebi
Kajang	Kebi
Senduk	Kebi
Raden	Kebi
Tarup	Kebi
Kangkung	Kebi
Lidi	Kebi
Baso	Kebi
Godong	Kebi
Mane	NLTK
Sembilan	Kebi
Taman	Kebi
Jetis	Kebi
Melirang	Kebi
Canggu	Kebi
Baulu	Kebi
Mengkudu	Kebi
Pepas	Kebi
Evergreen	NLTK
Awash	NLTK
Tarik	Kebi
Rodok	Kebi
Kurung	Kebi
Tombolo	NLTK
Garung	Kebi
Tajuk	Kebi
Gobang	Kebi
Dian	Kebi
Gita	Kebi
Bandar	Kebi
Panjunan	Kebi
Makmur	Kebi
Labang	Kebi
Jabung	Kebi
Tireman	NLTK
Tiga	Kebi
Gandul	Kebi
Sail	NLTK
Prabu	Kebi
Lite	NLTK
Sumbung	Kebi
Shibar	NLTK
Kubung	Kebi
Pelat	Kebi
Gonjak	Kebi
Tembong	Kebi
Ceruk	Kebi
Laine	NLTK
Putat	Kebi
Damar	Kebi
Bolo	NLTK
Mundu	Kebi
Fat	NLTK
Palas	Kebi
Mado	NLTK
Tegal	Kebi
Selamat	Kebi
Leek	NLTK
Dukuh	Kebi
Lemang	Kebi
Cukil	Kebi
Kentara	Kebi
Lingsir	Kebi
Tangar	Kebi
Sangir	Kebi
Prapatan	Kebi
Perdana	Kebi
Tendas	Kebi
Ilir	Kebi
Beringin	Kebi
Cengal	Kebi
Loji	Kebi
Petai	Kebi
Bega	Kebi
Kagok	Kebi
Kapas	Kebi
Teladas	Kebi
Praja	Kebi
Baho	NLTK
Bojo	NLTK
Timpuk	Kebi
Sempur	Kebi
Numbing	NLTK
Tawang	Kebi
Sintung	Kebi
Singkawang	Kebi
Pondok	Kebi
Dena	Kebi
Sandi	Kebi
Delik	Kebi
Tambang	Kebi
Bukur	Kebi
Paria	Kebi
Rajawali	Kebi
Semplak	Kebi
Bacem	Kebi
Made	NLTK
Dendang	Kebi
Temukus	Kebi
Jaya	Kebi
Demen	Kebi
Bahu	Kebi
Serai	Kebi
Done	NLTK
Merbau	Kebi
Rewak	Kebi
Jarum	Kebi
Menjangan	Kebi
Raba	Kebi
Canggal	Kebi
Tembok	Kebi
Mora	NLTK
Secang	Kebi
Letang	Kebi
Kerang	Kebi
Kulim	Kebi
Lembeng	Kebi
Saga	Kebi
Laras	Kebi
Kaca	Kebi
Campa	Kebi
Bere	NLTK
Gio	NLTK
Sangkala	Kebi
Pekat	Kebi
Proto	NLTK
Toko	Kebi
Delas	Kebi
Kerek	Kebi
Sadai	Kebi
Sais	Kebi
Kalpataru	Kebi
Bencah	Kebi
Luas	Kebi
Murung	Kebi
Gasang	Kebi
Rambutan	Kebi
Paal	NLTK
Katung	Kebi
Buduk	Kebi
Gohong	Kebi
Nangka	Kebi
Kutuk	Kebi
Penjor	Kebi
Pantik	Kebi
Stadion	Kebi
Soklat	Kebi
Libas	Kebi
Palama	NLTK
Pasir	Kebi
Batik	Kebi
Gadding	NLTK
Concong	Kebi
Aur	Kebi
Keramas	Kebi
Jungkat	Kebi
Sumur	Kebi
Kayangan	Kebi
Jumba	NLTK
Merek	Kebi
Kenteng	Kebi
Tebang	Kebi
Badar	Kebi
Kelua	Kebi
Mangkubumi	Kebi
Pia	NLTK
Kras	NLTK
Bogem	Kebi
Baru	Kebi
Satak	Kebi
Hatta	Kebi
Laksa	Kebi
Lino	NLTK
Sari	Kebi
Laru	Kebi
Sesap	Kebi
Wetan	Kebi
Aurora	Kebi
Sukamandi	Kebi
Bambung	Kebi
Ada	Kebi
Sulang	Kebi
Bucu	Kebi
Rempak	Kebi
Jantur	Kebi
Gantar	Kebi
Kunyit	Kebi
Valley	NLTK
Banter	Kebi
Patrol	NLTK
III	romawi
Lenggang	Kebi
Sawang	Kebi
Buran	NLTK
Rata	Kebi
Kamba	Kebi
Gerung	Kebi
Rompu	NLTK
Banua	Kebi
Lolak	Kebi
Janggi	Kebi
Suban	Kebi
Siong	Kebi
Baka	Kebi
Tualang	Kebi
Gundi	Kebi
Sogo	Kebi
Toho	NLTK
Belo	Kebi
Kemukus	Kebi
Buku	Kebi
Layuh	Kebi
Rampa	Kebi
Bulang	Kebi
Saskatoon	NLTK
Gapura	Kebi
Beliung	Kebi
Kandis	Kebi
Keresek	Kebi
Panca	Kebi
Sajang	Kebi
Kota	Kebi
Kamal	Kebi
Terong	Kebi
Lolong	Kebi
Jago	Kebi
Kancana	Kebi
Bengkel	Kebi
Pura	Kebi
Bohor	NLTK
Ungar	Kebi
Sepakat	Kebi
Pungkur	Kebi
Keruing	Kebi
Kali	Kebi
Terbis	Kebi
Dayu	Kebi
Jamblang	Kebi
Tolok	Kebi
Chili	NLTK
Langkas	Kebi
Kanoman	Kebi
Hijrah	Kebi
Tepal	NLTK
Centong	Kebi
Saing	Kebi
Jelu	Kebi
Permata	Kebi
Kincang	Kebi
Jila	Kebi
Bengkong	Kebi
Gandrung	Kebi
Tapen	NLTK
Senting	Kebi
Milir	Kebi
Sai	Kebi
Jirak	Kebi
Empang	Kebi
Meri	Kebi
Bobos	Kebi
Danguk	Kebi
Siwalan	Kebi
Tunggak	Kebi
Best	NLTK
Besusu	Kebi
Jipang	Kebi
Pangkah	Kebi
Tangkil	Kebi
Roto	NLTK
Lumar	Kebi
Bantal	Kebi
Kudi	Kebi
Budiman	Kebi
Pampang	Kebi
Gaharu	Kebi
Saren	Kebi
Rompi	Kebi
Kencong	Kebi
Bawang	Kebi
Morvin	NLTK
Jonggol	Kebi
Kepil	Kebi
Kober	Kebi
Sawit	Kebi
Siaga	Kebi
Kerabu	Kebi
Lahat	Kebi
Pasan	NLTK
Nyamuk	Kebi
Berry	NLTK
Bumi	Kebi
Kuari	Kebi
Lubuk	Kebi
Bancar	Kebi
Pajang	Kebi
Serang	Kebi
Sepat	Kebi
Bentak	Kebi
Masin	Kebi
Ngalau	Kebi
Kilang	Kebi
Sanggar	Kebi
Napal	Kebi
Carat	Kebi
Pasi	Kebi
Kemudi	Kebi
Gari	Kebi
Majir	Kebi
Beng	NLTK
Galuh	Kebi
Bongkok	Kebi
Jungkal	Kebi
Bayur	Kebi
Sungkai	Kebi
Mama	Kebi
Waling	NLTK
Tua	Kebi
Picung	Kebi
Mampir	Kebi
Nagara	Kebi
Purba	Kebi
Anggrek	Kebi
Duda	Kebi
Gongseng	Kebi
Arad	NLTK
Tumpang	Kebi
Codo	NLTK
Rambai	Kebi
Sudu	Kebi
Kurik	Kebi
Usar	Kebi
Magnesia	NLTK
Pagar	Kebi
Paseban	Kebi
Jagong	NLTK
Renda	Kebi
Melas	Kebi
Slendro	Kebi
Payang	Kebi
Wawa	Kebi
Sonder	Kebi
Dadap	Kebi
Gitik	Kebi
Beluluk	Kebi
Pesanggrahan	Kebi
Mamar	Kebi
Nain	NLTK
Besi	Kebi
Munding	Kebi
Doko	Kebi
Paya	Kebi
Puncak	Kebi
Geragai	Kebi
Medang	Kebi
Pakem	Kebi
Jurang	Kebi
Kais	Kebi
Pinggang	Kebi
Sialang	Kebi
Kosambi	Kebi
Soko	Kebi
Tandang	Kebi
Kapung	Kebi
Timur	Kebi
Muang	NLTK
Rasan	Kebi
Bagus	Kebi
Leer	NLTK
Dengkol	Kebi
Masohi	Kebi
Sie	NLTK
Buni	Kebi
Billa	NLTK
Balun	Kebi
Tamale	NLTK
Tunggang	Kebi
Pitak	Kebi
Bate	NLTK
Pasang	Kebi
Jaro	Kebi
Linge	NLTK
Celak	Kebi
Nae	NLTK
Kelara	Kebi
Ubar	Kebi
Temas	Kebi
Kerkap	Kebi
Gaji	Kebi
Parewa	Kebi
Sampir	Kebi
Pocong	Kebi
Panggang	Kebi
Berong	Kebi
Segah	Kebi
Banga	NLTK
Gelora	Kebi
Sewaka	Kebi
Solan	NLTK
Jubung	Kebi
Jorong	Kebi
Telap	Kebi
Blender	Kebi
Jember	Kebi
Beton	Kebi
Benteng	Kebi
Kapuk	Kebi
Salam	Kebi
Sosial	Kebi
Goes	NLTK
Pelas	Kebi
Pucang	Kebi
Kesemek	Kebi
Kapar	Kebi
Lancar	Kebi
Pandan	Kebi
Baco	Kebi
Bendi	Kebi
Wangi	Kebi
Baginda	Kebi
Ledeng	Kebi
Waras	Kebi
Lelak	Kebi
Ngablak	Kebi
Sasak	Kebi
Sanggang	Kebi
Rambung	Kebi
Bamban	NLTK
Umbul	Kebi
Inwood	NLTK
Sahang	Kebi
Delta	Kebi
Apas	Kebi
Jadi	Kebi
Arse	NLTK
Jambe	Kebi
Caracal	NLTK
Moat	NLTK
Sion	NLTK
Widoro	Kebi
Muncul	Kebi
Tombstone	NLTK
Bendar	Kebi
Lanji	Kebi
Kamu	Kebi
Sibak	Kebi
Tetap	Kebi
Kodi	Kebi
Alang-alang	Kebi
Gonggong	Kebi
Jabang	Kebi
Mata	Kebi
Suit	Kebi
Bening	Kebi
Bade	Kebi
Samudra	Kebi
Nusa	Kebi
Sentosa	Kebi
Lembak	Kebi
Manna	NLTK
Kolam	Kebi
Pinggir	Kebi
Serunai	Kebi
Kebo	Kebi
Kandang	Kebi
Sedong	Kebi
Purut	Kebi
Lanjut	Kebi
Kolak	Kebi
Munggur	Kebi
Phoenix	NLTK
Susu	Kebi
Gunggung	Kebi
Tikung	Kebi
Wungu	Kebi
Gobah	Kebi
Danyang	Kebi
Gandapura	Kebi
Ria	Kebi
Pubian	NLTK
Tunggul	Kebi
Guntur	Kebi
Mangir	Kebi
Wiru	Kebi
Batas	Kebi
Kingking	Kebi
Andang	Kebi
Samar	Kebi
Proklamasi	Kebi
Salak	Kebi
Jati	Kebi
Laksamana	Kebi
Papar	Kebi
Teleng	Kebi
Perian	Kebi
Ta	Kebi
Kohong	Kebi
Subah	NLTK
Moro	NLTK
Panglong	Kebi
Sekar	Kebi
Risa	Kebi
Kepet	Kebi
Sedah	Kebi
Babat	Kebi
Raja	Kebi
Gapit	Kebi
Runut	Kebi
Mujahidin	Kebi
Kisik	Kebi
Warsa	Kebi
Salto	Kebi
Maju	Kebi
Magani	NLTK
Ciluk	Kebi
Silir	Kebi
Sago	Kebi
Gelam	Kebi
Manggala	Kebi
Kulon	Kebi
Komodo	Kebi
Cekok	Kebi
Morong	Kebi
Baki	Kebi
Kolek	Kebi
Tembung	Kebi
Andong	Kebi
Tambar	Kebi
Sisir	Kebi
Caba	Kebi
Beeng	Kebi
Jarak	Kebi
Pone	NLTK
Cempaka	Kebi
Bilas	Kebi
Tou	NLTK
Lewat	Kebi
Kenari	Kebi
Limau	Kebi
Kalian	Kebi
Resun	NLTK
Pagon	Kebi
Surat	Kebi
Lebuh	Kebi
Wates	Kebi
Palar	Kebi
Taji	Kebi
Kristen	Kebi
Lambu	Kebi
Bobo	NLTK
Biru	Kebi
Baku	Kebi
Baruh	Kebi
Cengkong	Kebi
Panji	Kebi
Bobol	Kebi
Guntung	Kebi
Cikalang	Kebi
Kemangi	Kebi
Soco	NLTK
Darat	Kebi
Maleo	Kebi
Tanggul	Kebi
Era	Kebi
Warrior	NLTK
Silungkang	Kebi
Rada	Kebi
Siak	Kebi
Tengger	Kebi
Rambang	Kebi
Bundung	Kebi
Paluh	Kebi
Tambi	Kebi
Brambang	Kebi
Varna	NLTK
Auh	NLTK
Lembu	Kebi
Karet	Kebi
Gondrong	Kebi
Ikhwan	Kebi
Kalon	NLTK
Lugu	Kebi
Biting	Kebi
Pucung	Kebi
Pare	Kebi
Compreng	Kebi
Beti	Kebi
Kepel	Kebi
Duyung	Kebi
Bonang	Kebi
Porto	Kebi
Serah	Kebi
Ulin	Kebi
Alas	Kebi
Musyawarah	Kebi
Teritip	Kebi
Pamah	Kebi
Balela	Kebi
Seketeng	Kebi
Geneng	Kebi
Deras	Kebi
Jagung	Kebi
Alo	NLTK
Enterprise	NLTK
Garum	NLTK
Tungkup	Kebi
Barongan	Kebi
Baron	Kebi
Rambat	Kebi
Chandler	NLTK
Layang	Kebi
Tote	NLTK
Tumbak	Kebi
Petaling	Kebi
Sena	Kebi
Kadipaten	Kebi
Needham	NLTK
Bawak	Kebi
Asam	Kebi
Piton	Kebi
Mirah	Kebi
Lurah	Kebi
Maesan	Kebi
Taro	NLTK
Malapari	Kebi
Sejahtera	Kebi
Niur	Kebi
Petarangan	Kebi
Acapulco	NLTK
Komet	Kebi
Kelir	Kebi
Kayo	NLTK
Cepu	Kebi
Ketap	Kebi
Tebon	Kebi
Giring	Kebi
Sasa	Kebi
Lela	Kebi
Cottonwood	NLTK
Cemani	Kebi
Muka	Kebi
Menang	Kebi
Teja	Kebi
Mahal	Kebi
Lama	Kebi
Pandak	Kebi
Sekip	Kebi
Laguna	Kebi
Panggul	Kebi
Tempe	Kebi
Deru	Kebi
Besan	Kebi
Anilao	NLTK
Kedondong	Kebi
Jali	Kebi
Sorong	Kebi
Tanggung	Kebi
Gawan	Kebi
Delima	Kebi
Susut	Kebi
Boho	NLTK
Sebet	Kebi
Tambun	Kebi
Aron	Kebi
Fresno	NLTK
Kelayang	Kebi
Sawo	Kebi
Paul	Kebi
Tembelang	Kebi
Berangas	Kebi
Balok	Kebi
Setu	Kebi
Batara	Kebi
Ceper	Kebi
Sale	Kebi
Garuda	Kebi
Kempek	Kebi
Pukat	Kebi
Lampung	Kebi
Sulung	Kebi
Paras	Kebi
Mandah	Kebi
Manggar	Kebi
Pandai	Kebi
Langkai	Kebi
