Santos	NLTK
Basat	Kebi
Adelia	NLTK
Sinyo	Kebi
HIM	NLTK
VI	Romawi
Jewel	NLTK
Blatter	NLTK
Mian	NLTK
Ariana	NLTK
Tubagus	Kebi
Patriark	Kebi
Rosetta	NLTK
KAT	NLTK
Liza	NLTK
Slayer	NLTK
Painter	NLTK
Pitau	NLTK
Bangles	Lemmatization di nltk
Lamas	Lemmatization di nltk
Sai	Kebi
Domba	Kebi
Pical	NLTK
Mari	Kebi
Boston	NLTK
B.o.B	Satu kata bertitik
Will.i.am	Satu kata bertitik
Ge	Kebi
Portia	NLTK
Unique	NLTK
Okie	NLTK
Robbin	NLTK
Dido	NLTK
Mercedes	NLTK
Frederick	NLTK
Kasah	Kebi
dal	Kebi
Saadah	Kebi
Berger	NLTK
Dandi	Kebi
Dalem	Kebi
Marian	NLTK
Calmy	NLTK
Gish	NLTK
Sergiu	NLTK
Cornish	NLTK
Savage	NLTK
Baruch	NLTK
Toto	NLTK
Jin	Kebi
Soldado	NLTK
Priest	NLTK
KH.	Satu kata bertitik
Rajendra	NLTK
E.C.	Satu kata bertitik
Jemaah	Kebi
Belle	NLTK
Parra	NLTK
Bogart	NLTK
Cheshire	NLTK
Naik	Kebi
Baker	NLTK
Taji	Kebi
March	NLTK
Fryers	Lemmatization di nltk
Stam	NLTK
Gu	Kebi
Rosemary	NLTK
Maire	NLTK
Loco	NLTK
Dickens	NLTK
Bibit	Kebi
Breasted	NLTK
Di	Kebi
Jared	NLTK
Lane	NLTK
Sambi	Kebi
Luri	NLTK
Flores	NLTK
Erik	Kebi
Tunggang	Kebi
Zeppelin	NLTK
Angula	NLTK
Konrad	NLTK
Earl	NLTK
Palar	Kebi
Villa	NLTK
Cedric	NLTK
Matsu	NLTK
Sekret	Kebi
School	NLTK
Ardi	Kebi
Mercury	NLTK
Guruh	Kebi
Dave	NLTK
Lucy	NLTK
Ahmet	NLTK
Omar	NLTK
Haji	Kebi
Dunne	NLTK
Saki	Kebi
Abby	NLTK
Augustus	NLTK
No	Kebi
Frank	NLTK
Josh	NLTK
Tan	Kebi
Fred	NLTK
Vernon	NLTK
Pandu	Kebi
Butt	NLTK
Arctic	NLTK
Iswara	NLTK
Steed	NLTK
Florence	NLTK
Ilia	NLTK
Gaskins	NLTK
Daya	Kebi
Tegal	Kebi
Soler	NLTK
Maya	Kebi
Ratu	Kebi
Franc	NLTK
O	NLTK
KISS	NLTK
Randall	NLTK
RTM	Huruf Besar Semua
Steeve	NLTK
Walter	NLTK
Paris	Kebi
Oyong	Kebi
G.	Satu kata bertitik
Anja	Kebi
Poe	NLTK
Arifin	Kebi
Hillel	NLTK
Gumbira	Kebi
el	Kebi
Boney	NLTK
Nan	Kebi
Outlandish	NLTK
Roma	Kebi
Car	NLTK
Landes	Lemmatization di nltk
Sena	Kebi
High	NLTK
Trier	NLTK
Correa	NLTK
Kusuma	Kebi
Bullock	NLTK
Lew	NLTK
Brad	NLTK
Wonder	NLTK
Claudio	NLTK
Joss	NLTK
Michael	NLTK
Kahar	Kebi
Jay	NLTK
Enes	Kebi
Lili	Kebi
Supertramp	NLTK
Mindi	Kebi
L.A.	Satu kata bertitik
Toledo	NLTK
Daud	NLTK
Ami	Kebi
Kali	Kebi
Jan	NLTK
Sin	Kebi
Johannes	NLTK
Hening	Kebi
T.	Satu kata bertitik
Doe	NLTK
Tiffin	NLTK
Abel	NLTK
Lembu	Kebi
Swedish	NLTK
Alexander	NLTK
Diane	NLTK
Bravo	NLTK
Woodrow	NLTK
Maliki	Kebi
Bowles	Lemmatization di nltk
TTS	Huruf Besar Semua
Butler	NLTK
Taw	NLTK
Raven	NLTK
Tran	NLTK
Titien	NLTK
Samantha	NLTK
Cartwright	NLTK
Alonso	NLTK
Alvin	NLTK
Kristiani	Kebi
Servet	NLTK
Manda	Kebi
Edward	NLTK
Patrick	NLTK
Quintet	NLTK
Rocks	Lemmatization di nltk
SWAMI	NLTK
Oren	Kebi
Shane	NLTK
Lois	NLTK
Paco	NLTK
Natalia	NLTK
Bell	NLTK
Naim	Kebi
Dera	Kebi
Dora	NLTK
Veranda	NLTK
Merlin	NLTK
Gladys	NLTK
Bajang	Kebi
Seven	NLTK
Mukti	NLTK
Lens	Kebi
Clint	NLTK
Gosling	NLTK
Satu	Kebi
Ajun	Kebi
Spencer	NLTK
Sarah	NLTK
Immanuel	NLTK
Ni	Kebi
Meles	NLTK
Gnarls	Lemmatization di nltk
Dangerous	NLTK
Waterman	NLTK
Sigi	Kebi
Titian	NLTK
Jero	Kebi
Levels	Lemmatization di nltk
Anima	NLTK
I.	Satu kata bertitik
Constantine	NLTK
Sidy	NLTK
Tamam	Kebi
Bishop	NLTK
Ferri	NLTK
Hanks	Lemmatization di nltk
Read	NLTK
Sylvia	NLTK
Irene	NLTK
Warman	NLTK
Azali	Kebi
Killer	NLTK
Torsten	NLTK
Burns	Lemmatization di nltk
Fifie	NLTK
Fortes	Lemmatization di nltk
Hans	NLTK
Agil	Kebi
Crimson	NLTK
Shamir	NLTK
Paulin	NLTK
Walt	NLTK
Carrie	NLTK
Chapman	NLTK
Ara	Kebi
Harper	NLTK
Nigel	NLTK
Guillermo	NLTK
MC	Huruf Besar Semua
Curl	NLTK
Bailey	NLTK
Kick	NLTK
Carlin	NLTK
Tanner	NLTK
Usher	NLTK
Kasim	Kebi
Humphrey	NLTK
Noble	NLTK
Carlos	NLTK
Woodruff	NLTK
Lawrence	NLTK
Sandal	Kebi
Samudra	Kebi
By	NLTK
Ari	Kebi
Bin	Kebi
Kejora	Kebi
Solomon	NLTK
Andrea	NLTK
Maro	Kebi
Carr	NLTK
Nuraga	Kebi
Samak	Kebi
Nurse	NLTK
Hanif	Kebi
Malai	Kebi
Slipknot	NLTK
City	NLTK
F.X.	Satu kata bertitik
Vaughn	NLTK
Cary	NLTK
Ammi	Kebi
Black	NLTK
Amoroso	NLTK
Gusti	Kebi
Sundari	Kebi
Lucretia	NLTK
Slim	NLTK
Man	Kebi
Browning	NLTK
Vijay	NLTK
Hong	NLTK
Paolo	NLTK
Sersan	Kebi
Mutu	Kebi
Gie	NLTK
Mark	Kebi
Alexius	NLTK
Sukma	Kebi
Suk	Kebi
Abd.Rahim	Satu kata bertitik
Amar	Kebi
Finn	NLTK
Rana	Kebi
Hwa	NLTK
E.S.	Satu kata bertitik
Gun	Kebi
Sandra	Kebi
Fetus	Kebi
Troy	NLTK
Ernst	NLTK
Romain	NLTK
Zet	Kebi
Beha	Kebi
Marque	NLTK
Numa	NLTK
DC	Huruf Besar Semua
Amini	NLTK
Ali	Kebi
Fosse	NLTK
Wainwright	NLTK
Mumpuni	Kebi
Barney	NLTK
Reynold	NLTK
Stop	Kebi
ANM	Huruf Besar Semua
Bunda	Kebi
Toldo	NLTK
Alba	NLTK
Jeremy	NLTK
Bourdon	NLTK
Crouch	NLTK
Note	NLTK
Lorraine	NLTK
Sinaga	Kebi
Papa	Kebi
TLB	Huruf Besar Semua
Zeta	Kebi
Ole	NLTK
Damme	NLTK
Orchestra	NLTK
Topi	Kebi
Gilbert	NLTK
Willow	NLTK
Maulana	Kebi
Ephraim	NLTK
Formica	NLTK
Asa	Kebi
Gunther	NLTK
Q	NLTK
Mercer	NLTK
Gale	NLTK
Basten	NLTK
Darryl	NLTK
Barnard	NLTK
Unity	NLTK
Vampire	NLTK
Luke	NLTK
Ceper	Kebi
Mena	Kebi
Crocker	NLTK
Heath	NLTK
Tek	Kebi
Saa	NLTK
Won	NLTK
Mae	NLTK
dan	Kebi
Naib	Kebi
Ujang	Kebi
Topan	Kebi
Power	NLTK
Anita	NLTK
Dinar	Kebi
Terrorizer	NLTK
Moo	NLTK
Jawed	NLTK
Tribe	NLTK
anugerah	Kebi
Coates	Lemmatization di nltk
Charlie	NLTK
Soter	NLTK
Morales	Lemmatization di nltk
Pennant	NLTK
Leno	NLTK
Yok	NLTK
Cheng	NLTK
Party	NLTK
Amil	Kebi
Henny	NLTK
Ernest	NLTK
Cak	Kebi
Tang	Kebi
Um	Kebi
Baptis	Kebi
Addie	NLTK
Cakra	Kebi
Dutra	NLTK
Grant	NLTK
Las	Kebi
Pele	NLTK
Rabi	Kebi
Coelho	NLTK
Amber	NLTK
Evangeline	NLTK
Nathan	NLTK
Diego	NLTK
Jeanette	NLTK
Gene	NLTK
Yuda	Kebi
Mol	Kebi
Base	NLTK
Bagus	Kebi
Casey	NLTK
Mats	NLTK
Vicky	NLTK
Arnold	NLTK
Vino	NLTK
Hope	NLTK
Jenny	NLTK
Peter	NLTK
Pot	Kebi
Teresa	NLTK
Todd	NLTK
Bramble	NLTK
Aria	Kebi
Catherine	NLTK
Haab	NLTK
Barkas	Kebi
Fender	NLTK
Ryder	NLTK
Blind	NLTK
Scotty	NLTK
Sunan	Kebi
Konstantin	NLTK
Petit	NLTK
International	NLTK
Stein	NLTK
Gading	Kebi
Eutanasia	Kebi
Rachel	NLTK
Masyarakat	Kebi
Winston	NLTK
Elisabeth	NLTK
Serge	NLTK
Constant	NLTK
Kimberly	NLTK
Project	NLTK
Tahir	Kebi
Singleton	NLTK
Bing	NLTK
Angela	NLTK
Rafi	Kebi
Nira	Kebi
Island	NLTK
Hun	Kebi
Persada	Kebi
Sawyers	Lemmatization di nltk
Cherry	NLTK
Lat	Kebi
Eru	Kebi
Sonny	NLTK
Yayi	Kebi
Heng	Kebi
Faust	NLTK
Purba	Kebi
Hannibal	NLTK
Kamil	Kebi
Celia	NLTK
Sri	Kebi
Bun	Kebi
Lionel	NLTK
Phantom	NLTK
Kuan	NLTK
Brownback	NLTK
Project.R	Satu kata bertitik
Roses	Lemmatization di nltk
Petty	NLTK
Serenade	NLTK
Tulus	Kebi
Solar	Kebi
Trio	Kebi
Fretes	Lemmatization di nltk
Amos	NLTK
Francois	NLTK
Kemp	NLTK
Gloria	NLTK
Jam	Kebi
Dixit	NLTK
Belly	NLTK
Carlo	NLTK
Bulan	Kebi
Pape	NLTK
Chad	NLTK
Bloc	NLTK
Thema	NLTK
Rush	NLTK
Loren	NLTK
Frog	NLTK
Jacob	NLTK
Kirana	Kebi
Shandy	NLTK
Stoner	NLTK
Cassandra	NLTK
Albrecht	NLTK
Gadis	Kebi
Vital	Kebi
Woe	NLTK
Caroline	NLTK
Rand	NLTK
Chili	NLTK
Ida	Kebi
TUN	Kebi
Wilhelmina	NLTK
Situ	Kebi
Kan	Kebi
Fitch	NLTK
Maki	Kebi
wa	Kebi
Ter	Kebi
Medan	Kebi
Pussycat	NLTK
Children	Lemmatization di nltk
Olla	NLTK
Rosier	NLTK
Natalie	NLTK
Diah	Kebi
Asha	NLTK
Kung	Kebi
Lila	Kebi
Kartika	Kebi
Suci	Kebi
Dr.PM	Satu kata bertitik
Shelter	NLTK
Dylan	NLTK
Good	NLTK
Maxim	NLTK
Boral	NLTK
Graeme	NLTK
Marco	NLTK
Bangun	Kebi
Philip	NLTK
Oswald	NLTK
Olga	NLTK
Polo	Kebi
Arena	Kebi
Bang	Kebi
Kuini	Kebi
Bartram	NLTK
Granger	NLTK
Soares	Lemmatization di nltk
Ferguson	NLTK
Wirawan	Kebi
Kalam	Kebi
Yon	NLTK
IX	Romawi
Astor	NLTK
Cabot	NLTK
Dudley	NLTK
Cha	NLTK
Jasmine	NLTK
Fay	NLTK
Chico	NLTK
Mariana	NLTK
Isabella	NLTK
Giri	Kebi
Rajab	Kebi
Gottlieb	NLTK
Hill	NLTK
Universitas	Kebi
Chester	NLTK
Maduro	NLTK
Monteith	NLTK
Laet	NLTK
Holm	NLTK
Novel	Kebi
Predator	Kebi
Sofia	NLTK
Bucky	NLTK
Kat	NLTK
Ludwig	NLTK
Theodore	NLTK
Endang	Kebi
Tani	Kebi
Griffin	NLTK
Abigail	NLTK
Patek	Kebi
Sita	Kebi
Hulk	NLTK
Archibald	NLTK
Barnabas	NLTK
Taro	NLTK
Yew	NLTK
Tripy	NLTK
Sakis	Lemmatization di nltk
Pribadi	Kebi
Jagger	NLTK
Lucia	NLTK
Elizabeth	NLTK
Tukar	Kebi
Rubin	Kebi
Alfonso	NLTK
Ellen	NLTK
Gilles	NLTK
Cullen	NLTK
Tile	Kebi
Green	NLTK
Pilar	Kebi
Belinda	NLTK
Frangipane	NLTK
Lula	NLTK
Ameen	NLTK
Sudi	Kebi
Cakar	Kebi
Brede	NLTK
Fi	NLTK
Lien	NLTK
Eliot	NLTK
MJ	Huruf Besar Semua
Arias	Lemmatization di nltk
Loy	NLTK
Donna	NLTK
Andi	NLTK
Puncheon	NLTK
Tatty	NLTK
Cynthia	NLTK
Daryl	NLTK
Octavian	NLTK
Sade	NLTK
Paradise	NLTK
Saint	NLTK
Sergei	NLTK
Hanna	NLTK
Reese	NLTK
Blake	NLTK
Sherman	NLTK
Enow	NLTK
RJ	Huruf Besar Semua
Rafik	Kebi
R.S.	Satu kata bertitik
Chuck	NLTK
Sumbang	Kebi
Irama	Kebi
Crosse	NLTK
Stradivari	NLTK
Sally	NLTK
Foster	NLTK
Hoed	Lemmatization di nltk
Georgia	NLTK
Aam	NLTK
Vladimir	NLTK
B.F.	Satu kata bertitik
Wiji	Kebi
Gottfried	NLTK
Octave	NLTK
Robin	NLTK
Rami	Kebi
Becky	NLTK
Junior	Kebi
Brock	NLTK
Francis	NLTK
BoA	NLTK
Datar	Kebi
Sr.	Satu kata bertitik
Setia	Kebi
January	NLTK
Ihsan	Kebi
Sparrow	NLTK
Kaiser	NLTK
AJ	Huruf Besar Semua
Aurora	Kebi
Kuning	Kebi
York	NLTK
Dries	Lemmatization di nltk
Emir	Kebi
Genevois	NLTK
Ball	NLTK
Lord	NLTK
Starling	NLTK
C.S.	Satu kata bertitik
Daft	NLTK
Gita	Kebi
Fall	NLTK
Louise	NLTK
Frazer	NLTK
E.J.	Satu kata bertitik
Syam	Kebi
Law	NLTK
Pina	NLTK
Umbara	Kebi
Monkey	NLTK
Della	NLTK
Lim	NLTK
Malam	Kebi
Suu	NLTK
Ne	NLTK
Elijah	NLTK
Flea	NLTK
Taufan	Kebi
Swank	NLTK
Palfrey	NLTK
Pink	NLTK
Boyce	NLTK
Rahmatullah	Kebi
Maud	NLTK
Martial	NLTK
Terry	NLTK
Coventry	NLTK
Fuller	NLTK
Bonnet	NLTK
Forman	Kebi
Norman	NLTK
Jozy	NLTK
Teddy	NLTK
Megan	Kebi
Maxwell	NLTK
XO	Huruf Besar Semua
Pica	Kebi
Brawn	NLTK
Habib	Kebi
Kardinal	Kebi
Yam	NLTK
Charlene	NLTK
Melon	NLTK
Friend	NLTK
Jim	Kebi
Ann	NLTK
Cassius	NLTK
EXO	Huruf Besar Semua
Yuris	Kebi
Isabelle	NLTK
Matan	Kebi
Adnan	Kebi
Justo	NLTK
Aga	Kebi
Knight	NLTK
Young	NLTK
Douglas	NLTK
Joanna	NLTK
Ilham	Kebi
Dewan	Kebi
Kenan	Kebi
Degen	Kebi
Avery	NLTK
Desi	NLTK
Levy	NLTK
Mahmud	Kebi
Bony	NLTK
Z.	Satu kata bertitik
JP	Huruf Besar Semua
Bender	NLTK
Jesus	NLTK
Bahar	Kebi
Bean	NLTK
Albin	NLTK
Lola	NLTK
Hilaria	NLTK
Lengah	Kebi
Kumai	Kebi
EBS	Huruf Besar Semua
Whitehead	NLTK
Paquet	NLTK
Grazer	NLTK
Laurence	NLTK
Sabina	NLTK
Aris	Kebi
Straits	Lemmatization di nltk
Rice	NLTK
Malevolent	NLTK
Ralph	NLTK
Gabe	NLTK
Turner	NLTK
Ric	NLTK
R.K.	Satu kata bertitik
Happy	NLTK
Vanessa	NLTK
Goodwill	NLTK
Khair	Kebi
Suri	Kebi
Dean	NLTK
Alen	NLTK
and	NLTK
Cast	NLTK
Nance	NLTK
Teller	NLTK
Lloyd	NLTK
Way	NLTK
Raymond	NLTK
Danielle	NLTK
Artha	NLTK
Tom	Kebi
Tat	NLTK
Sanders	NLTK
Poppy	NLTK
Ross	NLTK
Bertha	NLTK
Martel	NLTK
Mas	Kebi
Dude	NLTK
Tudor	NLTK
Ran	NLTK
Windu	Kebi
Ming	NLTK
Adrenaline	NLTK
Letitia	NLTK
Juri	Kebi
Jean-Christophe	NLTK
Christophe	NLTK
Antonio	NLTK
Reeve	NLTK
Yu	Kebi
Waltz	NLTK
Lance	NLTK
Firman	NLTK
Leontin	Kebi
Moos	Lemmatization di nltk
Chris	NLTK
ten	NLTK
Pia	NLTK
Kati	Kebi
Akmal	Kebi
Routh	NLTK
Negara	Kebi
Heather	NLTK
Harvey	NLTK
Rau	Kebi
Ion	Kebi
Rum	Kebi
Count	NLTK
Denys	Lemmatization di nltk
Dakota	NLTK
Rijal	Kebi
Rod	NLTK
Delapan	Kebi
Wayne	NLTK
C.G.E.	Satu kata bertitik
Roberta	NLTK
Eddies	Lemmatization di nltk
Sidi	Kebi
Hakim	Kebi
Bora	Kebi
Dia	Kebi
Sahid	Kebi
Sen	Kebi
Service	NLTK
Bayar	Kebi
Howard	NLTK
Skillet	NLTK
Dadali	Kebi
Tike	Kebi
Mick	NLTK
Sulla	NLTK
Russ	NLTK
W-inds.	Satu kata bertitik
YMCK	Huruf Besar Semua
Arroyo	NLTK
Sanda	Kebi
J.B.S.	Satu kata bertitik
Farouk	NLTK
Alf	Kebi
Mandra	NLTK
Donald	NLTK
MIQ	Huruf Besar Semua
Carrizo	NLTK
Karier	Kebi
Paddy	NLTK
Rex	NLTK
Frederica	NLTK
Messenger	NLTK
Solis	Kebi
Zakiah	Kebi
Ethan	NLTK
Winona	NLTK
With	NLTK
Buhl	NLTK
Bless	NLTK
Bana	NLTK
Hasan	Kebi
Bungsu	Kebi
Bagi	Kebi
Tasty	NLTK
Rita	NLTK
King	NLTK
Perot	Kebi
Madeline	NLTK
Perry	NLTK
Hummel	NLTK
Arne	NLTK
Chiefs	Lemmatization di nltk
Nicky	NLTK
Duta	Kebi
Capa	Kebi
Nair	NLTK
Dee	NLTK
Ring	Kebi
Rocker	NLTK
R	NLTK
Skye	NLTK
Lukas	NLTK
Hermes	NLTK
Stamp	NLTK
Scott	NLTK
Putut	Kebi
Petter	NLTK
Mantilla	NLTK
Wisnu	Kebi
Murad	Kebi
Harden	NLTK
Ujud	Kebi
Yap	NLTK
Mayer	NLTK
Cantor	NLTK
Gertrude	NLTK
Barrow	NLTK
Secondhand	NLTK
Wolfgang	NLTK
Leighton	NLTK
Sang	Kebi
B.A.P	Satu kata bertitik
Mouly	NLTK
Rosary	NLTK
Paisley	NLTK
Aji	Kebi
Bakar	Kebi
Adlai	NLTK
Jobs	Lemmatization di nltk
Nuri	Kebi
Marie	NLTK
Olivier	NLTK
Baria	NLTK
Wei	NLTK
Pope	NLTK
Dimple	NLTK
Damayanti	NLTK
Beadle	NLTK
Cucuk	Kebi
Antigone	NLTK
Bur	Kebi
Andre	NLTK
Loris	NLTK
Out	NLTK
Ita	NLTK
Wilfred	NLTK
Sibylla	NLTK
Keng	Kebi
Zen	Kebi
Farmer	NLTK
Falak	Kebi
Vall	NLTK
Maureen	NLTK
Sadin	Kebi
Honda	NLTK
Wolf	NLTK
June	NLTK
Main	Kebi
Boni	NLTK
Martens	Lemmatization di nltk
Charles	NLTK
Timo	NLTK
Habibi	Kebi
Emmanuel	NLTK
Rumor	Kebi
Wiles	Lemmatization di nltk
W.	Satu kata bertitik
Del	NLTK
Amis	Kebi
Chinese	NLTK
Lys	NLTK
Rubik	Kebi
Kok	Kebi
Charlotte	NLTK
Geoff	NLTK
Alois	NLTK
XII	Romawi
Fatah	Kebi
Pasteur	Kebi
Boy	NLTK
Wass	Lemmatization di nltk
Saturday	NLTK
Mak	Kebi
Canales	Lemmatization di nltk
Tuanku	Kebi
Sunu	Kebi
Dae	NLTK
Tema	Kebi
Sook	NLTK
Zo	NLTK
Yaya	NLTK
Wilson	NLTK
Irwin	NLTK
Beast	NLTK
Burn	NLTK
Frankenstein	NLTK
S.K.	Satu kata bertitik
Ucu	Kebi
Sanjay	NLTK
Timi	Kebi
Calvin	NLTK
Woodward	NLTK
Gal	NLTK
So	NLTK
Sabah	Kebi
Justin	NLTK
Ness	NLTK
Lengkong	Kebi
Records	Lemmatization di nltk
B.Z.	Satu kata bertitik
Jacobus	NLTK
Ananta	NLTK
Crane	NLTK
MBLAQ	Huruf Besar Semua
Giuseppe	NLTK
Paskah	Kebi
Anna	NLTK
Bianca	NLTK
Romney	NLTK
Tracey	NLTK
Ning	Kebi
Heer	NLTK
Roosevelt	NLTK
Fendy	NLTK
Stan	Kebi
Lawalata	Kebi
Samba	Kebi
Gabriel	NLTK
Puan	Kebi
Rupert	NLTK
Bawa	Kebi
Pim	NLTK
Both	NLTK
Olson	NLTK
Inch	NLTK
Pinto	NLTK
Lama	Kebi
Aja	Kebi
Shastri	NLTK
Luluk	Kebi
Pullman	NLTK
Punjabi	NLTK
Gayatri	NLTK
Tengku	Kebi
U	Kebi
Nine	NLTK
Syukur	Kebi
Permana	Kebi
Winter	Kebi
Bos	Kebi
Verre	NLTK
Danny	NLTK
Isa	Kebi
Kumala	Kebi
Nazar	Kebi
Monica	NLTK
Bacharach	NLTK
Gamble	NLTK
G	NLTK
Citra	Kebi
Nala	Kebi
Kees	NLTK
Anjar	Kebi
Smit	NLTK
Wilhelm	NLTK
Lemari	Kebi
Furlan	NLTK
Kusen	Kebi
Vengeance	NLTK
Guru	Kebi
Octavia	NLTK
Lemony	NLTK
Once	Kebi
Ahmadi	NLTK
Nguyen	NLTK
TIO	Huruf Besar Semua
Then	NLTK
Brett	NLTK
Kalashnikov	NLTK
Inisiasi	Kebi
Mahmoud	NLTK
Maman	Kebi
D	NLTK
Cliff	NLTK
Esperance	NLTK
Melinda	NLTK
Dozer	NLTK
Buck	NLTK
Shearer	NLTK
Doris	NLTK
Hayes	Lemmatization di nltk
Fare	NLTK
Brown	NLTK
Dal	Kebi
Turco	NLTK
Geoffrey	NLTK
Maka	Kebi
Ya	Kebi
Rajiv	NLTK
Hotel	Kebi
Bomber	Kebi
Boys	Lemmatization di nltk
Elisha	NLTK
Vivek	NLTK
On	Kebi
Colin	NLTK
TH.	Satu kata bertitik
Sadie	NLTK
Park	NLTK
Serigala	Kebi
Zat	Kebi
Kieran	NLTK
Blanca	NLTK
Bowie	NLTK
Eileen	NLTK
Oda	NLTK
Ju	NLTK
Keri	Kebi
Kin	Kebi
Meggy	NLTK
Niels	NLTK
Sayed	Lemmatization di nltk
Kristin	NLTK
Crows	Lemmatization di nltk
Hank	NLTK
Hutch	NLTK
Awi	Kebi
Navy	NLTK
Kamal	Kebi
Pereira	NLTK
Nathaniel	NLTK
Vena	Kebi
Noah	NLTK
Timur	Kebi
Ji	Kebi
Pat	NLTK
Non	Kebi
Harta	Kebi
Snow	NLTK
Milla	NLTK
Pane	NLTK
Adem	Kebi
Inez	NLTK
Fakih	Kebi
Julie	NLTK
Bart	NLTK
Shannon	NLTK
Yan	NLTK
Blues	NLTK
Romaine	NLTK
Zahid	Kebi
Long	Kebi
Fatur	Kebi
Sini	Kebi
Rusa	Kebi
Seymour	NLTK
Adu	Kebi
Mora	NLTK
Hay	NLTK
Mayo	NLTK
Wetter	NLTK
Metin	NLTK
Lyndon	NLTK
T	NLTK
Checker	NLTK
Winnie	NLTK
Kou	NLTK
Lech	NLTK
Ramon	NLTK
Aqua	NLTK
Mbah	Kebi
Chet	NLTK
Konstantinos	NLTK
Biasa	Kebi
Singer	NLTK
Bahri	Kebi
Gladstone	NLTK
Benny	NLTK
Purnama	Kebi
Mamie	NLTK
Chloe	NLTK
Baltimore	NLTK
Bracker	NLTK
Ringer	NLTK
T.A.T.u.	Satu kata bertitik
Didik	Kebi
Hammerer	NLTK
Bruce	NLTK
Samaras	Lemmatization di nltk
Oleh	Kebi
Cilik	Kebi
Otto	NLTK
Ana	Kebi
Schreiner	NLTK
Guan	NLTK
Nuke	NLTK
Hillary	NLTK
Perwira	Kebi
Leonid	Kebi
Laurel	NLTK
Shorter	NLTK
Sidik	Kebi
Owen	NLTK
Alec	NLTK
Rainy	NLTK
Garden	NLTK
Mascara	NLTK
sang	Kebi
Demy	NLTK
diri	Kebi
Dill	NLTK
Hamilton	NLTK
Panglima	Kebi
Mentari	Kebi
Kusti	Kebi
Cory	NLTK
Selena	NLTK
Bernard	NLTK
Yes	NLTK
Den	Kebi
Magic	NLTK
Sheila	NLTK
Mahardika	Kebi
Titi	Kebi
Kawin	Kebi
Serrano	NLTK
Juan	NLTK
Johan	Kebi
Safar	Kebi
Sud	NLTK
APT	NLTK
Yasmin	Kebi
Shaw	NLTK
Andreas	NLTK
Moi	NLTK
Iman	Kebi
Roland	NLTK
Brunet	NLTK
Sewaka	Kebi
Rahmah	Kebi
Gaga	Kebi
Bedene	NLTK
Creation	NLTK
Panca	Kebi
Knudsen	NLTK
Air	Kebi
Dewi	Kebi
Katharine	NLTK
Ram	Kebi
Mistry	NLTK
Go	NLTK
Princess	NLTK
Primus	NLTK
Bunton	NLTK
XV	Huruf Besar Semua
Rantau	Kebi
Kral	NLTK
Dicky	NLTK
Evelyn	NLTK
Serse	Kebi
Eon	Kebi
Infante	NLTK
Amin	Kebi
Susumu	NLTK
ID	Kebi
Ca	Kebi
Anes	NLTK
Quagmire	NLTK
Emma	NLTK
Dalia	Kebi
Giring	Kebi
H.M.A.	Satu kata bertitik
Arrowsmith	NLTK
Randy	NLTK
Priscilla	NLTK
Ken	Kebi
Club	NLTK
Udo	Kebi
Maskara	Kebi
Seme	NLTK
Ada	Kebi
Asking	Lemmatization di nltk
Ranger	NLTK
Christopher	NLTK
Lay	NLTK
Born	NLTK
Suzanne	NLTK
Reed	NLTK
An	NLTK
Eross	Lemmatization di nltk
Cana	NLTK
Shawn	NLTK
Gede	Kebi
Dieter	NLTK
Nebel	NLTK
Adipati	Kebi
Gregor	NLTK
Ledger	NLTK
Wells	Lemmatization di nltk
Misionaris	Kebi
Tits	Lemmatization di nltk
Squire	NLTK
Dina	Kebi
HW	Huruf Besar Semua
Close	NLTK
Date	NLTK
Gideon	NLTK
Trimurti	Kebi
Matthias	NLTK
M.T.	Satu kata bertitik
Sato	Kebi
Connie	NLTK
Chamberlain	NLTK
Dharma	NLTK
Wilder	NLTK
Oki	NLTK
Fei	NLTK
Gunnar	NLTK
Geng	Kebi
Hurt	NLTK
Lake	NLTK
Percy	NLTK
Funky	NLTK
Fully	NLTK
Patrice	NLTK
Taylor	NLTK
Roach	NLTK
Antonella	NLTK
Cam	Kebi
Spray	NLTK
Duo	NLTK
Rufus	NLTK
Jussi	NLTK
Fisher	NLTK
Haya	NLTK
Dika	NLTK
S	Kebi
Riley	NLTK
Andries	NLTK
Pearl	NLTK
Manul	NLTK
Sears	Lemmatization di nltk
R.E.	Satu kata bertitik
Mulder	NLTK
Lazy	NLTK
Hilary	NLTK
Duff	NLTK
F.T.	Satu kata bertitik
Joey	NLTK
Funk	NLTK
Vai	NLTK
JB	Huruf Besar Semua
Dik	Kebi
Dendi	Kebi
Pardo	NLTK
Mike	NLTK
Pole	NLTK
Lee	NLTK
Pablo	NLTK
Randal	NLTK
Mendes	Lemmatization di nltk
Downing	NLTK
Clerk	NLTK
Henrietta	NLTK
Ahlan	Kebi
Si	Kebi
Neves	Lemmatization di nltk
Carver	NLTK
Velvet	NLTK
Wulan	Kebi
milady	NLTK
Mulligan	NLTK
Talib	Kebi
Taur	Kebi
Annie	NLTK
Dubs	NLTK
Lie	NLTK
Debby	NLTK
Top	Kebi
Au	Kebi
Bonds	Lemmatization di nltk
Abdu	Kebi
Brandon	NLTK
Cetera	Kebi
Hip	Kebi
Hero	Kebi
Sumirat	Kebi
Ferrara	NLTK
Dalton	NLTK
Mong	Kebi
Miro	NLTK
Samudera	Kebi
Ezra	NLTK
Tracy	NLTK
Key	NLTK
Lolo	NLTK
Setiawan	Kebi
Melati	Kebi
Holt	NLTK
Chun	NLTK
Dolores	NLTK
Hopper	NLTK
Allan	NLTK
Cowan	NLTK
Prihatin	Kebi
Taruna	Kebi
Lucius	NLTK
Hurley	NLTK
Nails	Lemmatization di nltk
Perch	NLTK
Tung	Kebi
Boas	Lemmatization di nltk
Rosario	Kebi
Hung	NLTK
Luis	NLTK
Hunt	NLTK
Kelik	Kebi
Saga	Kebi
Polk	NLTK
Tai	NLTK
Tore	NLTK
Shoes	Lemmatization di nltk
Lincoln	NLTK
Stallman	NLTK
Putra	Kebi
Albert	NLTK
Ivy	NLTK
Herd	NLTK
Abidal	NLTK
Mukminin	Kebi
Dolphin	NLTK
Stephan	NLTK
X	Kebi
Ratna	Kebi
Khadam	Kebi
Stipe	NLTK
Nazir	Kebi
Cacau	Kebi
Uli	Kebi
Carter	Kebi
Wade	NLTK
Chambers	Lemmatization di nltk
Jung	Kebi
Enid	NLTK
Klasik	Kebi
Muhammad	Kebi
Mahesa	Kebi
Victor	NLTK
Two	NLTK
Juni	Kebi
Mi	Kebi
Wiseman	NLTK
Hugo	NLTK
Pedro	NLTK
Watts	Lemmatization di nltk
Rory	NLTK
Derry	NLTK
Joon	NLTK
Muslimin	Kebi
Collin	NLTK
Conrad	NLTK
Cohen	NLTK
Bom	Kebi
Briggs	NLTK
SEAMO	Huruf Besar Semua
Glover	NLTK
Yao	NLTK
Native	NLTK
Russian	NLTK
Hud	NLTK
Kalas	Kebi
Within	NLTK
Hawer	NLTK
Goni	Kebi
J.K.	Satu kata bertitik
Mann	NLTK
Cabanas	Lemmatization di nltk
Dian	Kebi
Viola	Kebi
Glory	NLTK
Vilhelm	NLTK
Van	NLTK
Death	NLTK
Pascual	NLTK
Karisma	Kebi
Bradley	NLTK
Hoddle	NLTK
Quo	NLTK
Marko	NLTK
Rosalind	NLTK
Joe	NLTK
Bertrand	NLTK
Erick	NLTK
Elliott	NLTK
Garang	Kebi
Tori	Lemmatization di nltk
Havens	Lemmatization di nltk
Tyler	NLTK
Hammer	NLTK
Rie	NLTK
Galt	NLTK
Mesut	Kebi
Pieter	NLTK
Daeng	Kebi
Taras	Kebi
Cader	NLTK
Sophia	NLTK
Fortune	NLTK
Sam	NLTK
Waters	Lemmatization di nltk
Aki	Kebi
Rahayu	Kebi
Glen	NLTK
Semak	Kebi
Sali	Kebi
Ward	NLTK
Kate	Kebi
Mashal	NLTK
Ruby	NLTK
Serdar	NLTK
Presley	NLTK
Bo	NLTK
Teras	Kebi
Marten	NLTK
Pepper	NLTK
H.	Satu kata bertitik
Peyton	NLTK
Alpha	NLTK
Trice	NLTK
Lena	Kebi
Mahmudi	NLTK
AG	Huruf Besar Semua
Delbert	NLTK
Madame	NLTK
Peggy	NLTK
Santa	Kebi
Antony	NLTK
St.	Satu kata bertitik
Omer	NLTK
Dooley	NLTK
Even	NLTK
Nam	NLTK
Galore	NLTK
Racer	NLTK
Keita	NLTK
Leigh	NLTK
Meng	NLTK
Counting	NLTK
Sisters	Lemmatization di nltk
Tumpal	Kebi
Marcello	NLTK
Bella	NLTK
Lewis	NLTK
Attar	NLTK
Pinda	Kebi
Spelling	NLTK
Aziz	Kebi
Christina	NLTK
Wood	NLTK
Bow	NLTK
Butch	NLTK
Barker	NLTK
Pahala	Kebi
Godfrey	NLTK
Netty	NLTK
Larin	NLTK
Tate	NLTK
Sa	Kebi
Randolph	NLTK
Mahdi	Kebi
Eugene	NLTK
Hana	Kebi
My	NLTK
Isidore	NLTK
Takdir	Kebi
Chip	NLTK
Maharani	Kebi
Cristina	NLTK
Nana	NLTK
Proctor	NLTK
Babcock	NLTK
Eagles	Lemmatization di nltk
Eros	NLTK
Alex	NLTK
Shriver	NLTK
RS	Huruf Besar Semua
Rebel	NLTK
MZ	Huruf Besar Semua
Big	NLTK
Dragon	Kebi
Yellow	NLTK
Barak	Kebi
Damara	NLTK
Rode	NLTK
Eden	NLTK
Barber	Kebi
KDI	Huruf Besar Semua
Werner	NLTK
Singh	NLTK
Enteng	Kebi
Wedel	Kebi
Burr	NLTK
Dell	NLTK
Padan	Kebi
Tania	Kebi
Paola	NLTK
T.R.I.A.D	Satu kata bertitik
Bunker	Kebi
Opera	Kebi
Khalifa	NLTK
Kelvin	NLTK
Till	NLTK
Beg	NLTK
Ridder	NLTK
Monty	NLTK
J.G.	Satu kata bertitik
Pascal	NLTK
Ku	Kebi
Naomi	NLTK
Gregg	NLTK
P.R.	Satu kata bertitik
Seok	Kebi
Hide	NLTK
Made	NLTK
Queen	NLTK
Thirteen	NLTK
Milo	NLTK
Spearing	NLTK
Sharon	NLTK
R.	Satu kata bertitik
y	NLTK
Bel	Kebi
Irvin	NLTK
Jelly	NLTK
Mater	NLTK
Titus	NLTK
Candy	NLTK
Snoop	NLTK
Granat	Kebi
St	NLTK
Daniele	NLTK
Klaus	NLTK
Awal	Kebi
Yip	NLTK
Anne	NLTK
Stiller	NLTK
Fletcher	NLTK
Agger	NLTK
Susi	NLTK
Kayo	NLTK
Rosalia	NLTK
Abang	Kebi
Ide	Kebi
Claire	NLTK
Mayang	Kebi
Celsius	Kebi
Julien	NLTK
Java	NLTK
Rives	Lemmatization di nltk
Valencia	NLTK
Theo	NLTK
Sock	NLTK
Gunung	Kebi
Joan	NLTK
Monk	NLTK
Mango	NLTK
Carmen	NLTK
Norbert	NLTK
Bush	NLTK
Cartes	Lemmatization di nltk
Agam	Kebi
Pertiwi	Kebi
Motte	NLTK
Sparks	NLTK
Garner	NLTK
Diamond	NLTK
Helen	NLTK
Lopes	Lemmatization di nltk
Gong	Kebi
Emerald	NLTK
James	NLTK
Lilian	NLTK
Ho	NLTK
Dane	NLTK
Huh	Kebi
Chromy	NLTK
Austin	NLTK
Gates	Lemmatization di nltk
Kasai	Kebi
Gradasi	Kebi
Sahara	Kebi
B	NLTK
Given	NLTK
Ramadan	Kebi
Men	NLTK
Dominique	NLTK
Lady	NLTK
Cain	NLTK
Monster	Kebi
Cornelia	NLTK
CL	Huruf Besar Semua
Warren	NLTK
K.	Satu kata bertitik
Guy	NLTK
Jr.	Satu kata bertitik
Kyu	NLTK
Suwandi	NLTK
Baby	NLTK
Hoon	NLTK
Kwan	NLTK
Tobias	NLTK
Ron	NLTK
Mika	Kebi
Laksmi	Kebi
Cook	NLTK
Vila	Kebi
Muller	NLTK
Camilla	NLTK
Gees	Lemmatization di nltk
Saber	NLTK
As	Kebi
Kids	NLTK
Chrissie	NLTK
Mack	NLTK
Po	Kebi
Muslim	Kebi
Nik	Kebi
Naif	Kebi
D.	Satu kata bertitik
Terri	NLTK
Edmund	NLTK
Russell	NLTK
Eduardo	NLTK
Pamela	NLTK
Delia	NLTK
Boyer	NLTK
Ds	Lemmatization di nltk
Zan	Kebi
Wawa	Kebi
Novo	NLTK
Try	NLTK
Cate	NLTK
Gervais	NLTK
Lestari	Kebi
den	Kebi
Floyd	NLTK
Jessica	NLTK
Kay	NLTK
Saleh	Kebi
Vincenzo	NLTK
Electra	NLTK
Sha	NLTK
Caid	NLTK
Sleep	NLTK
DJ	Huruf Besar Semua
Wea	NLTK
Chord	NLTK
Benedict	NLTK
Fanny	NLTK
Irena	NLTK
te	Kebi
Sander	NLTK
D.I.	Satu kata bertitik
Melody.	Satu kata bertitik
Fighters	Lemmatization di nltk
Scoot	NLTK
Bando	Kebi
Kuman	Kebi
Chase	NLTK
Nahak	Kebi
Ricky	NLTK
Kazi	NLTK
DeMerit	NLTK
Zeus	NLTK
Chains	Lemmatization di nltk
H.O.T.	Satu kata bertitik
Reginald	NLTK
Elle	NLTK
Gilang	Kebi
Hind	NLTK
Price	NLTK
Lil	Kebi
Hausen	NLTK
Leila	NLTK
Rukiah	Kebi
Katinka	NLTK
Moss	NLTK
Wyss	NLTK
Balthasar	NLTK
Amine	NLTK
Bani	Kebi
Y.	Satu kata bertitik
Foo	NLTK
Anis	Kebi
Hamzah	Kebi
Rupiah	Kebi
Perrier	NLTK
Francisco	NLTK
Kiat	Kebi
Gil	NLTK
Grey	NLTK
Restu	Kebi
Han	NLTK
Aku	Kebi
Leter	Kebi
Devoured	Lemmatization di nltk
Field	NLTK
Alo	NLTK
Tenacious	NLTK
Bowker	NLTK
Ezekiel	NLTK
Alchemy	NLTK
Victoria	NLTK
Boris	NLTK
Bismarck	NLTK
Winehouse	NLTK
Edmond	NLTK
Ahsan	Kebi
VII	Romawi
Berlin	NLTK
Gook	NLTK
Grot	NLTK
Jamie	NLTK
Peppers	Lemmatization di nltk
Bujang	Kebi
Ocean	NLTK
Joy	NLTK
Padang	Kebi
Nusa	Kebi
Chaka	NLTK
Johanna	NLTK
to	Kebi
Donnie	NLTK
Arya	Kebi
Sau	Kebi
Maria	Kebi
Hirofumi	NLTK
Feist	NLTK
Ike	NLTK
Bass	NLTK
Bambang	Kebi
Gonzalo	NLTK
Bah	Kebi
Ong	Kebi
Franklin	NLTK
Led	NLTK
Athena	NLTK
Mob	Kebi
Syd	NLTK
Beni	Kebi
Isak	Kebi
Guntur	Kebi
Lago	Kebi
Duma	NLTK
Elliot	NLTK
Arwana	Kebi
Neil	NLTK
Mada	Kebi
Che	NLTK
Libels	Lemmatization di nltk
Rica	Kebi
Justice	NLTK
Ching	NLTK
Simon	NLTK
Wahid	Kebi
Harris	NLTK
Irma	NLTK
Seth	NLTK
Indy	NLTK
Mona	NLTK
Armida	NLTK
Judas	NLTK
Ati	Kebi
Al	Kebi
Junius	NLTK
Jude	NLTK
Randa	Kebi
Moch.	Satu kata bertitik
Teguh	Kebi
Tiffany	NLTK
Lovelock	NLTK
Marques	Lemmatization di nltk
Z	Kebi
Roon	NLTK
Harmon	NLTK
Susanna	NLTK
North	NLTK
Evert	NLTK
Dunst	NLTK
Alain	NLTK
Annette	NLTK
Khar	NLTK
Keen	NLTK
Tae	NLTK
Gunter	NLTK
Missy	NLTK
Fleming	NLTK
Gerard	NLTK
Monkeys	Lemmatization di nltk
Imam	Kebi
Sloan	NLTK
Helmes	Lemmatization di nltk
Mirza	NLTK
Fenny	NLTK
Jordan	NLTK
Apam	Kebi
Sean	NLTK
Bianco	NLTK
Clifford	NLTK
Lear	NLTK
Guns	Lemmatization di nltk
Chang	NLTK
Sasa	Kebi
Nepa	NLTK
Yabu	NLTK
Brilliant	NLTK
Amril	Kebi
Eldin	NLTK
Napalm	Kebi
Platt	NLTK
Silva	NLTK
Laksamana	Kebi
Jurnalis	Kebi
Angel	Kebi
Damon	NLTK
Bain	Kebi
Hijau	Kebi
Kara	Kebi
Bess	NLTK
Tuan	Kebi
Coverage	NLTK
Goo	NLTK
Medina	NLTK
House	NLTK
Church	NLTK
Portman	NLTK
Rajesh	NLTK
Sivan	NLTK
Himawan	NLTK
Maurice	NLTK
Japan	NLTK
Tanjung	Kebi
Corona	NLTK
Wee	NLTK
Ae	NLTK
Sunny	NLTK
KM	Huruf Besar Semua
Dorman	Kebi
Chol	NLTK
Salma	NLTK
Palla	NLTK
Lancaster	NLTK
Palma	Kebi
Conte	NLTK
Udi	Kebi
Ahmed	NLTK
Basta	NLTK
Crew	NLTK
Hein	NLTK
Agus	Kebi
Tommy	NLTK
Kuya	Kebi
Poulter	NLTK
Yo	NLTK
Jara	Kebi
Doughty	NLTK
Bolling	NLTK
Ambo	NLTK
Mouse	NLTK
Fitri	Kebi
Hiram	NLTK
Learns	Lemmatization di nltk
MH.	Satu kata bertitik
Home	NLTK
Daler	NLTK
Jeremias	NLTK
Blash	NLTK
Merpati	Kebi
Josip	NLTK
Fabian	NLTK
Banda	Kebi
Erie	NLTK
Agnes	NLTK
Plus	Kebi
Pu	NLTK
Dini	Kebi
Chiles	Lemmatization di nltk
Rhodes	NLTK
Fathers	Lemmatization di nltk
Rath	NLTK
Paulus	NLTK
Mahesh	NLTK
Abraham	NLTK
Matter	NLTK
V	Kebi
Matthieu	NLTK
Mile	NLTK
Plaza	Kebi
Jun	Kebi
Islam	Kebi
Nizam	NLTK
Bandang	Kebi
Groove	NLTK
Duchess	NLTK
Lu	Kebi
Stephen	NLTK
Steppe	NLTK
Noda	Kebi
Gabor	Kebi
Joseph	NLTK
Miguel	NLTK
Manai	Kebi
Amedeo	NLTK
Adam	NLTK
Rose	NLTK
Roger	NLTK
Salmon	Kebi
Train	NLTK
Spall	NLTK
Zac	NLTK
Psychic	NLTK
Abadi	Kebi
Savitri	NLTK
Karet	Kebi
Ebenezer	NLTK
Indri	NLTK
Glean	NLTK
Merah	Kebi
Horner	NLTK
Lamb	NLTK
Hot	Kebi
Tal	Kebi
Clavier	NLTK
Strong	NLTK
Daze	NLTK
Superman	NLTK
Durst	NLTK
Mahkota	Kebi
Obi	Kebi
Tarkas	Kebi
Gable	NLTK
Lulu	NLTK
Lynne	NLTK
CN	Huruf Besar Semua
Karti	Kebi
Dustin	NLTK
Tanaka	NLTK
Jeff	NLTK
Aimee	NLTK
Block	NLTK
Yakin	Kebi
Berlian	Kebi
F.	Satu kata bertitik
Kiki	NLTK
Bum	Kebi
Orkes	Kebi
Lina	NLTK
Cyrus	NLTK
Band	NLTK
Tyrone	NLTK
Patel	NLTK
Goran	NLTK
Takayuki	NLTK
Vita	NLTK
Rodney	NLTK
Jerome	NLTK
Cat	Kebi
Jerry	NLTK
Yana	NLTK
Muse	NLTK
Corinna	NLTK
Abate	NLTK
Tempest	NLTK
Dalle	NLTK
Demi	Kebi
Angels	Lemmatization di nltk
Kembang	Kebi
Husbands	Lemmatization di nltk
Barbara	NLTK
G.J.	Satu kata bertitik
Hurst	NLTK
Min	Kebi
Izzard	NLTK
Meri	Kebi
Jackman	NLTK
Twain	NLTK
Saif	Kebi
Stefan	NLTK
Kribo	Kebi
Mars	Kebi
Lot	Kebi
Smith	NLTK
Spike	NLTK
Datuk	Kebi
Romance	NLTK
Wahib	Kebi
ABBA	Huruf Besar Semua
Warni	Kebi
Basil	Kebi
Bolot	Kebi
Curie	NLTK
Buyung	Kebi
Son	NLTK
Bintang	Kebi
Bilal	Kebi
Rather	NLTK
Morning	NLTK
Kristen	Kebi
Carl	NLTK
Llama	NLTK
Alif	Kebi
Muno	Kebi
XI	NLTK
Dire	NLTK
Nane	NLTK
Romero	NLTK
Newton	Kebi
Bullet	NLTK
Planes	Lemmatization di nltk
Muntu	Kebi
Bridges	Lemmatization di nltk
O.	Satu kata bertitik
Pas	Kebi
Mesa	NLTK
OAG	Huruf Besar Semua
Carol	NLTK
Apple	NLTK
Alam	Kebi
Summers	Lemmatization di nltk
Ilir	Kebi
Jibril	Kebi
Rawa	Kebi
Jong	NLTK
Elia	NLTK
Thalia	NLTK
MahaDewa	Kebi
DUARTE	Huruf Besar Semua
ST	NLTK
Freddie	NLTK
Klem	Kebi
Morris	NLTK
Ponce	NLTK
Agatha	NLTK
R.M.S.	Satu kata bertitik
Cheney	NLTK
Putu	Kebi
Rangga	Kebi
Munch	NLTK
Badge	NLTK
Cox	NLTK
MZA	Huruf Besar Semua
Jukes	Lemmatization di nltk
Aguinaldo	NLTK
Louisa	NLTK
Raka	Kebi
Johnny	NLTK
Skee	NLTK
Aram	Kebi
Gani	Kebi
Ben	NLTK
Masayu	Kebi
Mano	NLTK
K	NLTK
Trivium	NLTK
Shola	NLTK
Creed	NLTK
Cortez	NLTK
Gamma	Kebi
Davy	NLTK
Welles	Lemmatization di nltk
Sandy	NLTK
Tahan	Kebi
Emily	NLTK
Donat	Kebi
Avian	NLTK
Pollack	NLTK
Vira	NLTK
Woods	Lemmatization di nltk
Dai	Kebi
Scrooge	NLTK
Branch	NLTK
Margarita	NLTK
Weber	NLTK
Adinda	Kebi
H.G.	Satu kata bertitik
Chickens	Lemmatization di nltk
Sue	NLTK
Dag	NLTK
Skinner	NLTK
Sori	Kebi
Morton	NLTK
Efendi	Kebi
Hilda	NLTK
Moral	Kebi
GT	Huruf Besar Semua
Atik	NLTK
Norah	NLTK
Gatot	Kebi
Storm	NLTK
Hardy	NLTK
Asma	Kebi
Glazer	NLTK
Hijab	Kebi
Herling	NLTK
Crazy	NLTK
Brood	NLTK
Tain	NLTK
Testone	NLTK
Romeo	NLTK
Varas	Lemmatization di nltk
Avenged	Lemmatization di nltk
Tag	NLTK
Cannibal	NLTK
Byron	NLTK
Akbar	Kebi
Page	NLTK
Tapping	NLTK
Muara	Kebi
Heck	NLTK
Puspa	Kebi
Hubble	NLTK
Tedder	NLTK
Mr.	Satu kata bertitik
Kane	Kebi
Pangestu	Kebi
K.N.	Satu kata bertitik
Slank	NLTK
Ohm	Kebi
Guram	Kebi
tiga	Kebi
Rasyid	Kebi
Woo	NLTK
XYZ	Huruf Besar Semua
Tusk	NLTK
Syekh	Kebi
Trinity	NLTK
Nicolas	NLTK
Kotoko	NLTK
Kent	NLTK
Adela	NLTK
Giovanni	NLTK
Stern	NLTK
Helge	NLTK
Mel	Kebi
Dani	NLTK
Patricia	NLTK
Flo	NLTK
Hetty	NLTK
Pipes	Lemmatization di nltk
Lith	NLTK
Covey	NLTK
Jauhari	Kebi
Bay	NLTK
Linus	NLTK
Hough	NLTK
Nobs	NLTK
Kafka	NLTK
Hop	Kebi
Pesek	Kebi
Belay	NLTK
Shin	NLTK
Webber	NLTK
Bara	Kebi
Rosa	NLTK
Insigne	NLTK
in	Kebi
Blair	NLTK
Dodo	NLTK
Muda	Kebi
Lily	NLTK
la	Kebi
Bowo	Kebi
Gol	Kebi
Balan	Kebi
Cowboy	NLTK
Gamal	Kebi
Super	Kebi
Sheares	Lemmatization di nltk
April	Kebi
Girls	Lemmatization di nltk
LVT	Huruf Besar Semua
Yun	NLTK
Hello	NLTK
Sick	NLTK
Earring	NLTK
Lamela	Kebi
Godwin	NLTK
Juang	Kebi
Burgess	NLTK
Anderson	NLTK
Nick	NLTK
Machar	NLTK
Serra	NLTK
Mina	Kebi
Dong	Kebi
Amara	NLTK
G.A.	Satu kata bertitik
Tyke	NLTK
Berg	NLTK
Kama	Kebi
Vega	NLTK
XIII	Romawi
Walsh	NLTK
Zone	Kebi
Galih	Kebi
Looms	Lemmatization di nltk
L.	Satu kata bertitik
Laurin	NLTK
Sojourner	NLTK
Dion	NLTK
Warwick	NLTK
Salim	Kebi
Bak	Kebi
Brazil	NLTK
Nina	NLTK
Ansari	Kebi
Marine	Kebi
Tukul	Kebi
Cage	NLTK
Archimedes	NLTK
Coker	NLTK
Withers	NLTK
Fajar	Kebi
Syarif	Kebi
Cipta	Kebi
Snicket	NLTK
Poco	NLTK
Kandar	Kebi
Kit	Kebi
Nil	NLTK
Ria	Kebi
Maiden	NLTK
Murphy	NLTK
Valiant	NLTK
Piotr	NLTK
Katy	NLTK
Kathy	NLTK
Shankar	NLTK
Hukum	Kebi
Flitter	NLTK
Bellow	NLTK
Gatra	Kebi
Pitter	NLTK
Said	Kebi
Marina	NLTK
Child	NLTK
Henry	Kebi
Asaph	NLTK
Marah	Kebi
Alexandra	NLTK
Dying	NLTK
Gunawan	Kebi
Martyn	NLTK
Lana	Kebi
Virginia	Kebi
Sylva	NLTK
Maksim	Kebi
Potter	NLTK
Ban	Kebi
Cardona	NLTK
Garth	NLTK
Loo	NLTK
Andika	Kebi
Jack	NLTK
Pantelis	NLTK
Nako	NLTK
Arm	NLTK
Combs	Lemmatization di nltk
Willy	NLTK
VIII	Romawi
Barrios	Lemmatization di nltk
Wan	Kebi
Turut	Kebi
Cahill	NLTK
Garrison	NLTK
Heinrich	NLTK
Becker	NLTK
Angelina	NLTK
Max	NLTK
Randi	Kebi
Wilkinson	NLTK
Francisca	NLTK
Anastasia	NLTK
Mudi	Kebi
Cindai	Kebi
Zamzam	Kebi
Dale	NLTK
Mara	Kebi
Marcos	NLTK
Alexis	NLTK
Bee	NLTK
Billie	NLTK
Shan	NLTK
Daphne	NLTK
Jason	NLTK
Sala	Kebi
Hughes	NLTK
Permaisuri	Kebi
Jonas	NLTK
Sebastian	NLTK
Cut	Kebi
Jonah	NLTK
Denis	NLTK
Whiting	NLTK
Prabu	Kebi
Hackman	NLTK
Tess	NLTK
Tree	NLTK
Woon	NLTK
Bebi	Kebi
Seamus	NLTK
Hu	NLTK
Hare	NLTK
Suda	Kebi
Vang	NLTK
Montana	NLTK
Lean	NLTK
Degan	Kebi
Lightning	NLTK
Sunrise	NLTK
Sylvester	NLTK
Matti	NLTK
Kian	Kebi
Goof	NLTK
Beatrice	NLTK
Rahul	NLTK
Luka	Kebi
Wira	Kebi
Jasper	NLTK
Abu	NLTK
Jones	NLTK
Camel	NLTK
Lucky	NLTK
Mohr	NLTK
Irving	NLTK
Morgan	NLTK
Is	NLTK
Ananda	Kebi
Abdi	Kebi
Bae	NLTK
Chubby	NLTK
Carpenter	NLTK
Selly	NLTK
Everett	NLTK
Ito	NLTK
Sultan	Kebi
Anggara	Kebi
Mahatma	Kebi
JYJ	Huruf Besar Semua
Shay	NLTK
Sara	Kebi
Weekend	NLTK
ter	Kebi
Almira	NLTK
Fu	NLTK
Tipper	NLTK
Bagas	Kebi
Kaku	Kebi
Perin	Kebi
Jaja	Kebi
Morin	NLTK
Criss	NLTK
Tata	Kebi
Weaving	NLTK
de	Kebi
Willie	NLTK
Tubman	NLTK
Fleet	NLTK
G.H.	Satu kata bertitik
Doke	NLTK
Rima	Kebi
Baldwin	NLTK
Driver	NLTK
Bi	Kebi
Cole	NLTK
Larry	NLTK
Drew	NLTK
Ilya	NLTK
Hi	Kebi
Eloge	NLTK
Vincent	NLTK
Barrett	NLTK
Martin	NLTK
J	NLTK
H.C.	Satu kata bertitik
Dewa	Kebi
Aloysius	NLTK
Korban	Kebi
Cinta	Kebi
Capra	NLTK
Syahid	Kebi
Caesar	NLTK
Senses	Lemmatization di nltk
Bong	Kebi
Melodia	NLTK
Iras	Kebi
Emery	NLTK
Guna	Kebi
Kanda	Kebi
Erasmus	NLTK
Chen	NLTK
Duncan	NLTK
Puppies	Lemmatization di nltk
Soe	Kebi
Indra	Kebi
Walters	Lemmatization di nltk
Clarence	NLTK
Patricio	NLTK
Sami	Kebi
Widi	Kebi
Dias	Kebi
Sage	NLTK
Santon	NLTK
Azamat	Kebi
Carole	NLTK
H.O.T	Satu kata bertitik
Shi	NLTK
Dinda	Kebi
Tack	NLTK
Bram	NLTK
Ambrose	NLTK
Sapta	Kebi
Thierry	NLTK
Konan	Kebi
Dt.	Satu kata bertitik
Mailman	NLTK
Geraldine	NLTK
Chitra	NLTK
Nikolai	NLTK
Irons	Lemmatization di nltk
Cone	NLTK
Tasrif	Kebi
Seng	Kebi
Josephine	NLTK
Kui	Kebi
Gibson	NLTK
Capel	NLTK
Kahin	Kebi
Koki	Kebi
Marsh	NLTK
Scaloni	NLTK
Pong	NLTK
Kathryn	NLTK
Agre	NLTK
Mason	Kebi
Dana	Kebi
Candra	Kebi
Ruth	NLTK
ZZ	Huruf Besar Semua
Tanya	Kebi
Cathy	NLTK
Amien	Kebi
Trump	NLTK
Kyle	NLTK
Orson	NLTK
Mortimer	NLTK
Rafael	NLTK
Marek	NLTK
TOR	NLTK
Bobby	NLTK
Latif	Kebi
Schneider	NLTK
Beatrix	NLTK
Irish	NLTK
Porcupine	NLTK
Lynn	NLTK
Lin	Kebi
La	Kebi
Tertius	NLTK
Kano	Kebi
Die	NLTK
Anyang	Kebi
Susie	NLTK
Rock	NLTK
Bon	Kebi
Mikael	NLTK
Kus	Kebi
Ping	NLTK
III	Romawi
Goma	NLTK
Maarten	NLTK
Lambert	Kebi
Gera	Kebi
Null	NLTK
Bob	NLTK
Ok	NLTK
Jonathan	NLTK
Aaron	NLTK
Ira	Kebi
Benjamin	NLTK
Manny	NLTK
Mohammad	NLTK
Guido	NLTK
Badawi	NLTK
Dyer	NLTK
Maggie	NLTK
Parker	NLTK
Kafi	Kebi
Rais	Kebi
Slade	NLTK
M.I.L.K	Satu kata bertitik
Parto	NLTK
Busby	NLTK
Sein	Kebi
Strange	NLTK
Nils	NLTK
Coke	NLTK
Rahman	Kebi
Siddhartha	NLTK
Ricardo	NLTK
Saka	Kebi
Turk	NLTK
Judi	Kebi
Aulia	Kebi
U.	Satu kata bertitik
Antik	Kebi
Baxter	NLTK
Hagi	NLTK
Lo	Kebi
Kemal	Kebi
Allen	NLTK
Josiah	NLTK
Mien	NLTK
Evanescence	NLTK
Blaine	NLTK
Wichita	NLTK
Vladislav	NLTK
Manga	NLTK
Pringle	NLTK
Cindy	NLTK
Brained	Lemmatization di nltk
Kadir	Kebi
Untouchable	NLTK
Havel	NLTK
Boa	NLTK
Dye	NLTK
Merman	NLTK
Anton	NLTK
Ibing	Kebi
Duri	Kebi
N.W.A.	Satu kata bertitik
Angelo	NLTK
Ruddy	NLTK
Space	NLTK
Effendi	NLTK
Brendan	NLTK
Arthur	NLTK
Cyril	NLTK
Brothers	Lemmatization di nltk
Frison	NLTK
Pratt	NLTK
Musa	NLTK
Alim	Kebi
Raphael	NLTK
Stewart	NLTK
Sawyer	NLTK
Pussy	NLTK
Taft	NLTK
Chick	NLTK
Miriam	NLTK
Leopold	NLTK
Tabitha	NLTK
Rudi	Kebi
Curver	NLTK
Laurie	NLTK
Roque	NLTK
Ishmael	NLTK
Bukit	Kebi
Anas	NLTK
Doll	NLTK
Light	NLTK
Sabines	Lemmatization di nltk
Precious	NLTK
Head	NLTK
Lucian	NLTK
Kee	NLTK
Burgh	NLTK
Sompong	Kebi
Ashraf	NLTK
Aras	Kebi
Grace	NLTK
Toh	Kebi
Gin	Kebi
Christos	NLTK
Darren	NLTK
Cavendish	NLTK
Stevan	NLTK
Bas	Kebi
A.Tee	Satu kata bertitik
Color	NLTK
Oh	Kebi
Steve	NLTK
Racun	Kebi
Daun	Kebi
Sid	NLTK
Afiat	Kebi
Bose	NLTK
Guz	NLTK
Radius	Kebi
Ave	NLTK
Hafiz	Kebi
Rochelle	NLTK
Began	Lemmatization di nltk
Last	NLTK
Kris	NLTK
ZARD	Huruf Besar Semua
Macan	Kebi
Bunuh	Kebi
CB	Huruf Besar Semua
Coco	NLTK
Shah	NLTK
Vives	NLTK
Philharmonic	NLTK
Martha	NLTK
Vina	NLTK
Hiroyuki	NLTK
Munshi	NLTK
Speer	NLTK
Tiara	Kebi
Chou	NLTK
Yeo	NLTK
Handler	NLTK
Crosby	NLTK
Heller	NLTK
Brooks	Lemmatization di nltk
Springer	NLTK
Crow	NLTK
Nara	Kebi
Karya	Kebi
Illinois	NLTK
Sammer	NLTK
Cesare	NLTK
Jos	NLTK
Plant	NLTK
Golden	NLTK
Hikmat	Kebi
Pelt	NLTK
Gillian	NLTK
Cinderella	NLTK
Ray	NLTK
Petr	NLTK
Marc	NLTK
Hari	Kebi
Tegar	Kebi
Per	Kebi
Thatcher	NLTK
Lax	NLTK
Cello	NLTK
Andy	NLTK
Daniel	NLTK
Wahyu	Kebi
Wilders	Lemmatization di nltk
Lynch	NLTK
Radek	NLTK
Streep	NLTK
Bates	Lemmatization di nltk
Seaman	NLTK
Tora	NLTK
Rumi	Kebi
T.B.	Satu kata bertitik
Silvia	NLTK
Delima	Kebi
Corpse	NLTK
Cartier	NLTK
Rowland	NLTK
Reinhard	NLTK
Vela	NLTK
Hitchings	Lemmatization di nltk
Hau	NLTK
Arif	Kebi
Taufik	Kebi
Amal	Kebi
Yang	Kebi
Samsons	Lemmatization di nltk
E.E.	Satu kata bertitik
Koto	NLTK
Indah	Kebi
John	NLTK
Porno	Kebi
Casper	NLTK
Boyd	NLTK
Rida	Kebi
Nova	Kebi
Christian	NLTK
Senate	NLTK
Aso	Kebi
Mao	NLTK
Waits	Lemmatization di nltk
Tulung	Kebi
Halim	Kebi
Slash	NLTK
Goodyear	NLTK
Ting	Kebi
Prima	Kebi
P.	Satu kata bertitik
Downs	Lemmatization di nltk
Karim	Kebi
Pater	Kebi
of	NLTK
Fortunella	NLTK
Sigmund	NLTK
Case	NLTK
Edith	NLTK
Guava	NLTK
Sterling	NLTK
Mimi	Kebi
Suir	Kebi
Darnel	NLTK
Gray	NLTK
Tucker	NLTK
Parfait	NLTK
Burton	NLTK
Iga	Kebi
Martins	Lemmatization di nltk
Olaf	NLTK
Olivia	NLTK
Boros	Kebi
Just	NLTK
Steer	NLTK
Rena	Kebi
Ariel	NLTK
Puri	Kebi
Prudence	NLTK
Gore	NLTK
Suwita	Kebi
Clement	NLTK
Jari	Kebi
Vindex	NLTK
Nu	Kebi
Sol	Kebi
Niall	NLTK
Swan	NLTK
Asri	Kebi
Amour	NLTK
Jean-Pierre	NLTK
Gamaliel	NLTK
Tilda	NLTK
Ian	NLTK
Clare	NLTK
Raj	NLTK
Braid	NLTK
Artie	NLTK
Awang	Kebi
Risa	Kebi
Grosso	NLTK
Nathanael	NLTK
Tress	NLTK
Linden	NLTK
Than	NLTK
Graham	NLTK
Cork	NLTK
Edo	NLTK
Rhoda	NLTK
Corinne	NLTK
Cahaya	Kebi
Malik	Kebi
Drake	NLTK
Gerald	NLTK
Jacques	NLTK
Safari	Kebi
Bemba	NLTK
Calista	NLTK
Underwood	NLTK
Kiley	NLTK
Brittany	NLTK
Juliana	NLTK
Clinton	NLTK
Lacks	Lemmatization di nltk
Vance	NLTK
Bailee	NLTK
Putri	Kebi
Filippo	NLTK
A.S.	Satu kata bertitik
Trevor	NLTK
Yogi	Kebi
Pepe	Kebi
Bridge	NLTK
Plastic	NLTK
Suryani	Kebi
Rain	NLTK
Senda	Kebi
Basa	Kebi
MS	Huruf Besar Semua
Bridget	NLTK
Hertz	Kebi
Paula	NLTK
Craven	NLTK
Marshal	NLTK
Marsha	NLTK
Glenn	NLTK
Antara	Kebi
S.E.S.	Satu kata bertitik
Adriana	NLTK
R.M.	Satu kata bertitik
Immobile	NLTK
Washington	NLTK
E.	Satu kata bertitik
Smithies	Lemmatization di nltk
Hunter	NLTK
Dan	Kebi
Aly	NLTK
Ignatius	NLTK
MahaDewi	Kebi
Tari	Kebi
Cruise	NLTK
Jimmy	NLTK
Darwis	Kebi
Sagitarius	Kebi
FX	Huruf Besar Semua
Shun	NLTK
West	NLTK
Warp	NLTK
Stacy	NLTK
Blunt	NLTK
Toma	NLTK
Garibaldi	NLTK
Nahas	Kebi
Weatherly	NLTK
Asbak	Kebi
Loukas	NLTK
Bosch	NLTK
Paku	Kebi
D.M.C.	Satu kata bertitik
Sierra	NLTK
Acker	NLTK
mileage	NLTK
George	NLTK
Yudo	Kebi
Brandy	NLTK
Sawai	Kebi
Sans	NLTK
Leman	NLTK
Elihu	NLTK
Keith	NLTK
Kana	Kebi
Benson	NLTK
Kittel	NLTK
Kharisma	Kebi
Rick	NLTK
Dado	NLTK
Kathleen	NLTK
Zalim	Kebi
Tumpak	Kebi
Piet	NLTK
Ragnar	NLTK
Bode	NLTK
Kevin	NLTK
Wall	NLTK
e	Kebi
Derek	Kebi
Mami	Kebi
Sakai	Kebi
Golgi	NLTK
Kudus	Kebi
Lasso	NLTK
Alison	NLTK
Kawan	Kebi
II	Romawi
Cuthbert	NLTK
Sancho	NLTK
Clough	NLTK
Valentin	Kebi
Rug	NLTK
Kangen	Kebi
Herbert	NLTK
Komeng	Kebi
Juno	NLTK
Peel	NLTK
Villas	Lemmatization di nltk
Khalil	Kebi
Gary	NLTK
Atmo	NLTK
Holland	NLTK
Guyon	Kebi
Cici	Kebi
Una	NLTK
Colback	NLTK
Reis	NLTK
Janet	NLTK
Gigi	Kebi
Chandler	NLTK
Cherubin	NLTK
Yeni	NLTK
Val	NLTK
Woof	NLTK
Vidya	NLTK
J.	Satu kata bertitik
Lydia	NLTK
Lisan	Kebi
Amat	Kebi
Kamel	NLTK
Raden	Kebi
Budi	Kebi
Andam	Kebi
Amy	NLTK
Mat	Kebi
Yati	NLTK
Sabbath	NLTK
Moses	NLTK
Pee	NLTK
Nadi	Kebi
Carcass	NLTK
Satar	Kebi
Hubert	NLTK
W.D.	Satu kata bertitik
Little	NLTK
Mega	Kebi
Volta	NLTK
Lian	Kebi
Luna	NLTK
Budiman	Kebi
Brook	NLTK
Firth	NLTK
Margaret	NLTK
Salomon	NLTK
Coast	NLTK
Holden	NLTK
Ed	NLTK
Julius	NLTK
Sung	NLTK
Fanning	NLTK
Rainer	NLTK
Evan	NLTK
Jaqueline	NLTK
Saidi	Kebi
Jug	NLTK
Erasure	NLTK
Status	Kebi
Paus	Kebi
Learn	NLTK
Kang	Kebi
Pamungkas	Kebi
Asian	NLTK
Davies	Lemmatization di nltk
Jorge	NLTK
Saad	NLTK
Ketchup	NLTK
Marty	NLTK
Lara	Kebi
Astrid	NLTK
Hal	Kebi
Narendra	NLTK
Tam	Kebi
Nile	NLTK
Berry	NLTK
Back	NLTK
TJ	Huruf Besar Semua
Sea	NLTK
Pen	Kebi
Basir	Kebi
Best	NLTK
Akkad	NLTK
Burman	NLTK
Diesel	Kebi
Rinaldo	NLTK
Kempot	Kebi
Grand	NLTK
Mamo	NLTK
Dolly	NLTK
Timbul	Kebi
Franco	NLTK
Wright	NLTK
Slater	NLTK
Tofu	NLTK
Tompel	Kebi
Fuad	Kebi
Kitten	NLTK
Hugh	NLTK
Markus	NLTK
Dolls	Lemmatization di nltk
Asmara	Kebi
Leonard	NLTK
Knowledge	NLTK
Bond	NLTK
Mos	Lemmatization di nltk
Samad	Kebi
Perceval	NLTK
Real	Kebi
Garret	NLTK
Mandi	Kebi
Murat	NLTK
Tandy	NLTK
Lan	NLTK
Liv	NLTK
Justine	NLTK
Andrew	NLTK
Seri	Kebi
Arcade	NLTK
Lala	Kebi
Woody	NLTK
Rip	NLTK
Kelana	Kebi
Laurent	NLTK
Sienna	NLTK
Quicksilver	NLTK
Herman	NLTK
Manfred	NLTK
Margie	NLTK
Yoga	Kebi
Savant	NLTK
Nanda	Kebi
Lenny	NLTK
Harmony	NLTK
Nat	NLTK
Oka	NLTK
Patil	Kebi
Erwin	NLTK
Song	NLTK
Suid	NLTK
Blanco	NLTK
Zed	NLTK
Bumi	Kebi
Linda	NLTK
Swami	NLTK
Jamal	Kebi
Dunia	Kebi
D.o.t	Satu kata bertitik
Frederik	NLTK
Stich	NLTK
Tanda	Kebi
Oscar	NLTK
SM	Huruf Besar Semua
DMM	Huruf Besar Semua
Ucok	Kebi
Mantra	Kebi
Clive	NLTK
Amanda	NLTK
Balanta	NLTK
Nugraha	Kebi
Mills	Lemmatization di nltk
Seko	Kebi
INXS	Huruf Besar Semua
Gaby	NLTK
Matthew	NLTK
Birch	NLTK
Elm	NLTK
Baca	Kebi
Bobo	NLTK
Static	NLTK
Salam	Kebi
Shen	NLTK
Ramsey	NLTK
Alejandro	NLTK
BM.	Satu kata bertitik
Lupus	NLTK
Milner	NLTK
Hollo	NLTK
Tomas	NLTK
Kembar	Kebi
Milestone	NLTK
Apel	Kebi
Philippe	NLTK
Dayang	Kebi
San	NLTK
Friends	Lemmatization di nltk
Mok	Kebi
A	NLTK
In	Kebi
Teck	NLTK
Ella	NLTK
Sylvan	NLTK
M.	Satu kata bertitik
Toro	Kebi
Temin	Kebi
Teng	Kebi
Prakarsa	Kebi
Miranda	NLTK
Darius	NLTK
Pol	Kebi
Ferly	NLTK
Speed	NLTK
Abe	NLTK
Chena	NLTK
Temple	NLTK
Mighty	NLTK
Kai	NLTK
Jamrud	Kebi
Chilla	NLTK
Les	Kebi
Edgar	NLTK
Christofer	NLTK
Star	NLTK
Aries	Kebi
Jenna	NLTK
Halo	Kebi
Ibra	Kebi
Lima	Kebi
Signori	Lemmatization di nltk
Tamsil	Kebi
Early	NLTK
Spears	Lemmatization di nltk
Karel	NLTK
Carmine	NLTK
I	NLTK
Angsa	Kebi
Krishna	NLTK
Brian	NLTK
Miller	NLTK
Tipe	Kebi
Kolo	NLTK
Dunlop	NLTK
Rudy	NLTK
WaT	NLTK
Maia	NLTK
Frost	NLTK
Wise	NLTK
Parsons	Lemmatization di nltk
Donovan	NLTK
Debbie	NLTK
Reiter	NLTK
Ki	Kebi
Wallach	NLTK
Lusk	NLTK
Pine	NLTK
Kabir	Kebi
D.O.	Satu kata bertitik
Baron	Kebi
Phillip	NLTK
Miles	NLTK
Tong	Kebi
Carsten	NLTK
Jet	Kebi
Rob	NLTK
Electric	NLTK
Chamorro	NLTK
SPYAIR	Huruf Besar Semua
Terrence	NLTK
Malaka	Kebi
El	Kebi
William	NLTK
Alfred	NLTK
Infinite	NLTK
Sora	NLTK
Mikey	NLTK
Brin	NLTK
Hogan	NLTK
Phil	NLTK
Bayal	NLTK
Owl	NLTK
Patria	NLTK
Ton	Kebi
Alberto	NLTK
Battle	NLTK
God	NLTK
Corey	NLTK
Miki	NLTK
Jon	NLTK
Youth	NLTK
Sana	Kebi
Brenda	NLTK
Radin	Kebi
Pata	NLTK
Rabin	NLTK
Cancer	NLTK
Sakti	Kebi
Chao	NLTK
Joran	Kebi
Oli	Kebi
Book	NLTK
Innocent	NLTK
Windsor	NLTK
Laura	NLTK
Ading	Kebi
Kim	Kebi
Askar	Kebi
Emil	NLTK
Tao	NLTK
Hina	Kebi
Apostolos	NLTK
Kings	Lemmatization di nltk
Tirta	Kebi
Indiana	NLTK
Ah	Kebi
Idola	Kebi
Taslim	Kebi
Earworm	NLTK
Angie	NLTK
Dara	Kebi
Bebe	Kebi
Reasoner	NLTK
Hall	NLTK
Prince	NLTK
Sidney	NLTK
Poulard	NLTK
Janker	NLTK
Lover	NLTK
Sie	NLTK
Juvenal	NLTK
Reiner	NLTK
Suh	Kebi
Winger	NLTK
Jerun	Kebi
MOOMIN	Huruf Besar Semua
Riva	NLTK
Eddie	NLTK
Omelette	NLTK
Chain	NLTK
Selva	NLTK
Item	Kebi
Syed	NLTK
Silas	NLTK
Sabino	NLTK
Fico	NLTK
Leah	NLTK
Morel	NLTK
Ronni	NLTK
Sutan	Kebi
Revival	NLTK
De	Kebi
Eaves	NLTK
Sakura	Kebi
RedOne	Lemmatization di nltk
Joyce	NLTK
Hart	Kebi
Martinez	NLTK
Dawson	NLTK
Ravin	NLTK
Betet	Kebi
Emilia	NLTK
Vince	NLTK
Bryce	NLTK
Ai	Kebi
Brooke	NLTK
Nellie	NLTK
Oper	Kebi
Bianchi	NLTK
Buster	NLTK
Rolf	NLTK
Luigi	NLTK
Sani	Kebi
A.	Satu kata bertitik
Lawless	NLTK
Koller	NLTK
Crofts	Lemmatization di nltk
Susan	NLTK
Roy	NLTK
Tatang	Kebi
Kelly	NLTK
Joel	NLTK
Bottoms	Lemmatization di nltk
Finch	NLTK
Horst	NLTK
Collins	NLTK
Curry	NLTK
Ma	Kebi
Broccoli	NLTK
Norma	Kebi
Rainbow	NLTK
Munsyi	Kebi
Lester	NLTK
Nur	Kebi
Eva	NLTK
EVO	Huruf Besar Semua
Koda	Kebi
Ernie	NLTK
Freddy	NLTK
Atef	NLTK
Noel	NLTK
Joachim	NLTK
Senna	NLTK
Russel	NLTK
Gondrong	Kebi
Hildebrand	NLTK
Liz	NLTK
Reina	NLTK
Bird	NLTK
Nyak	Kebi
Nelson	NLTK
Chi	NLTK
Abbie	NLTK
Pierce	NLTK
Ruak	Kebi
Jalil	Kebi
Buyar	Kebi
Adrian	NLTK
Rebecca	NLTK
American	NLTK
David	NLTK
Rini	Kebi
Clover	NLTK
Melik	Kebi
Roda	Kebi
Benn	NLTK
Khan	NLTK
Sergio	NLTK
Suzan	NLTK
Panji	Kebi
Bayu	Kebi
Nurmala	Kebi
Erika	NLTK
Garuda	Kebi
H	NLTK
Lisa	NLTK
Foxes	Lemmatization di nltk
New	NLTK
Teka	Kebi
Boniface	NLTK
Map	Kebi
Tano	NLTK
Rutherford	NLTK
Lotte	NLTK
Kencana	Kebi
Billa	NLTK
Dwayne	NLTK
Ba	Kebi
Julia	NLTK
Mots	Lemmatization di nltk
Nestor	NLTK
Bunga	Kebi
Doyle	NLTK
Koch	NLTK
C.	Satu kata bertitik
Hui	NLTK
Manik	Kebi
Leslie	NLTK
Burt	NLTK
Martini	Kebi
Mammy	NLTK
Bening	Kebi
Marcia	NLTK
Vicious	NLTK
Goodman	NLTK
Booth	NLTK
Derrick	NLTK
Karma	Kebi
Jake	NLTK
Markis	Kebi
Jem	Kebi
Fana	Kebi
Burke	NLTK
Chia	NLTK
Wim	NLTK
Manuel	NLTK
Cool	NLTK
TVXQ	Huruf Besar Semua
Withe	NLTK
IV	Romawi
Morbid	NLTK
Archie	NLTK
O.B.	Satu kata bertitik
Neve	NLTK
Bahadur	Kebi
Belcher	NLTK
Clayton	NLTK
Jarvis	NLTK
RM.	Satu kata bertitik
Craig	NLTK
Revolusi	Kebi
Inception	NLTK
Kekal	Kebi
Reid	NLTK
Her	NLTK
Palermo	NLTK
Rama	Kebi
Greg	NLTK
Dev	NLTK
Ted	NLTK
List	NLTK
Frizzy	NLTK
Peron	Kebi
Suzy	NLTK
Borne	NLTK
Eddy	NLTK
Christ	NLTK
Simeon	NLTK
Jacky	NLTK
Kasih	Kebi
Kasino	Kebi
Keys	Lemmatization di nltk
Rudolph	NLTK
Yuri	Kebi
Tony	NLTK
Hiren	NLTK
Juhi	Kebi
S.O.S	Satu kata bertitik
Samuel	NLTK
Rove	NLTK
Tampi	Kebi
Rolls	Lemmatization di nltk
Dennis	NLTK
Arango	NLTK
Levi	NLTK
Veronica	NLTK
White	NLTK
Mitt	NLTK
Kandel	Kebi
baron	Kebi
Kirsten	NLTK
Roderick	NLTK
Baran	Kebi
You	NLTK
Murray	NLTK
Mull	NLTK
Sola	NLTK
Mario	NLTK
Haris	Kebi
Smalling	NLTK
Mandala	Kebi
Radu	Kebi
Aline	NLTK
Kaisar	Kebi
Posey	NLTK
Libby	NLTK
Levin	NLTK
Blinder	NLTK
Buchanan	NLTK
Canals	Lemmatization di nltk
Abbey	NLTK
Jeanne	NLTK
Sumpter	NLTK
Matta	NLTK
Rudolf	NLTK
Puspita	Kebi
Wai	Kebi
Run-D.M.C.	Satu kata bertitik
Ford	NLTK
SMAP	Huruf Besar Semua
Khir	NLTK
Tango	Kebi
Ethel	NLTK
Joanne	NLTK
Gordon	NLTK
Anggun	Kebi
Freya	NLTK
Dumas	Lemmatization di nltk
Mai	Kebi
Night	NLTK
Mary	NLTK
BR	Huruf Besar Semua
Kubin	Kebi
Luak	Kebi
Alan	NLTK
Canterbury	NLTK
Jane	NLTK
Agra	NLTK
Jef	NLTK
Mata	Kebi
Nelly	NLTK
Edar	Kebi
Brent	NLTK
A.N.	Satu kata bertitik
Anan	NLTK
Zain	NLTK
Ream	NLTK
Urs	NLTK
N.	Satu kata bertitik
Angus	Kebi
Karl	NLTK
Loach	NLTK
Basso	NLTK
Tin	Kebi
Lex	NLTK
Cuesta	NLTK
Mouth	NLTK
Dwight	NLTK
Shirley	NLTK
Mustika	Kebi
T.T.	Satu kata bertitik
Mini	Kebi
Zee	NLTK
Kirk	NLTK
Mus	Kebi
Nini	Kebi
Flock	NLTK
Villar	NLTK
Epik	Kebi
Hikam	Kebi
Syamsu	Kebi
Kreator	Kebi
Bounty	NLTK
Cicip	Kebi
Flack	NLTK
Art	NLTK
Aung	Kebi
Cleopatra	NLTK
Matt	NLTK
Chinchilla	NLTK
Gagap	Kebi
Will	NLTK
Antinous	NLTK
Guana	NLTK
E.H.	Satu kata bertitik
Chetty	NLTK
MoJo	NLTK
Neto	Kebi
Jules	NLTK
C.T.R.	Satu kata bertitik
Wong	Kebi
Saul	NLTK
Town	NLTK
Red	NLTK
Pato	NLTK
K.Will	Satu kata bertitik
Kodi	Kebi
Kristian	NLTK
Thuan	NLTK
Lindsay	NLTK
Li	NLTK
Bragi	NLTK
Marcel	NLTK
Holly	NLTK
Dirk	NLTK
Bonjol	Kebi
Aruan	Kebi
Infanta	NLTK
Roh	Kebi
Gaus	NLTK
Firdaus	Kebi
Theron	NLTK
Syamsir	Kebi
Na	Kebi
Spiegel	NLTK
Justina	NLTK
Xi	NLTK
Durant	NLTK
Group	NLTK
Garda	Kebi
May	NLTK
Bonar	Kebi
Kanon	Kebi
Sun	Kebi
Mubarak	Kebi
Hara	Kebi
Anak	Kebi
Fritz	NLTK
Stanley	NLTK
B.	Satu kata bertitik
H.M.	Satu kata bertitik
S.	Satu kata bertitik
Tri	NLTK
Wang	Kebi
Weeks	Lemmatization di nltk
Oskar	NLTK
Jalal	Kebi
Untung	Kebi
Antun	Kebi
Eta	Kebi
Sanger	NLTK
Dodd	NLTK
Doug	NLTK
Ghazi	NLTK
Audrey	NLTK
Roberto	NLTK
Jamin	Kebi
China	NLTK
Alphonse	NLTK
NSG	Huruf Besar Semua
Joni	NLTK
Cornelius	NLTK
Richard	NLTK
Siti	Kebi
Quinton	NLTK
Yuki	NLTK
Anthony	NLTK
Jaya	Kebi
Buddha	Kebi
Blue	NLTK
Kaj	NLTK
Brewster	NLTK
Heinz	NLTK
Fan	NLTK
Palun	Kebi
Helena	NLTK
Isaac	NLTK
Diva	NLTK
Ha	Kebi
Crackdown	NLTK
Didong	Kebi
Beverly	NLTK
Brunt	NLTK
Pollock	NLTK
Begin	NLTK
Nadir	Kebi
Raya	Kebi
Florent	NLTK
Cow	NLTK
Dame	Kebi
Ayu	Kebi
Jean	NLTK
Izumi	NLTK
Hayward	NLTK
Banana	NLTK
Lam	Kebi
Dead	NLTK
Helder	NLTK
Michelle	NLTK
Starlets	Lemmatization di nltk
Semakin	Kebi
Eli	NLTK
Steven	NLTK
Granit	Kebi
Scissor	NLTK
Vell	NLTK
Ivan	NLTK
Reuben	NLTK
Burnet	NLTK
Very	NLTK
Tiar	NLTK
Beau	NLTK
Kuang	Kebi
Winchester	NLTK
Abul	Kebi
Violet	Kebi
Porter	NLTK
Rimes	Lemmatization di nltk
Gepeng	Kebi
Mestika	Kebi
Pied	NLTK
Judy	NLTK
Griffith	NLTK
Sari	Kebi
Sharp	NLTK
Judith	NLTK
Theobald	NLTK
Cros	Lemmatization di nltk
Bloom	NLTK
Augustin	NLTK
Booker	NLTK
Sak	Kebi
Zaman	Kebi
Mantik	Kebi
Kader	Kebi
Uriah	NLTK
Pier	NLTK
Thomas	NLTK
Braille	Kebi
Otis	NLTK
Atomic	NLTK
Hinds	Lemmatization di nltk
Colt	NLTK
Iron	NLTK
Music	NLTK
Lou	NLTK
Wijaya	Kebi
Nul	NLTK
Viva	NLTK
Arend	NLTK
Koko	NLTK
Ante	NLTK
Cerci	NLTK
Canaan	NLTK
IU	Huruf Besar Semua
Mila	NLTK
Stephanie	NLTK
Nye	NLTK
Carnegie	NLTK
Hin	NLTK
Meg	NLTK
America	NLTK
Tika	Kebi
Luther	NLTK
Devon	NLTK
Christine	NLTK
Lev	NLTK
Marvin	NLTK
For	NLTK
Raja	Kebi
Agung	Kebi
Gregory	NLTK
Ham	Kebi
Tabah	Kebi
Gula	Kebi
Pace	Kebi
Irfan	NLTK
Unveils	Lemmatization di nltk
Curtis	NLTK
Atta	NLTK
XVIII	Huruf Besar Semua
Saura	NLTK
Addy	NLTK
Chance	NLTK
Schiavone	NLTK
Peto	NLTK
Venkata	NLTK
Isabel	NLTK
Sio	Kebi
Peres	Kebi
Sampurna	Kebi
Timor	NLTK
Sutra	Kebi
Paul	Kebi
Blur	NLTK
Angelica	NLTK
Elsa	NLTK
Buddy	NLTK
Cecilia	NLTK
Ingram	NLTK
Tua	Kebi
Muluk	Kebi
Advent	NLTK
ADA	Kebi
Zak	NLTK
Chicks	Lemmatization di nltk
Moody	NLTK
Carissa	NLTK
Luc	NLTK
Wisdom	NLTK
Reeves	Lemmatization di nltk
Sonja	NLTK
Hemed	Lemmatization di nltk
Donal	NLTK
Doping	Kebi
Paredes	Lemmatization di nltk
Fox	NLTK
Punk	Kebi
Minimal	Kebi
Alien	NLTK
Slovak	NLTK
JAM	Kebi
Mursal	Kebi
Johann	NLTK
Prakash	NLTK
hitam	Kebi
Amadou	NLTK
Gena	Kebi
Sevenfold	NLTK
Mecca	NLTK
Meriam	Kebi
Rafe	Kebi
Welling	NLTK
Stone	NLTK
Hale	NLTK
Wendy	NLTK
Port	NLTK
Raul	NLTK
Kuno	Kebi
Up	NLTK
Makos	Lemmatization di nltk
Luce	NLTK
E.A.	Satu kata bertitik
Lata	Kebi
Lobo	NLTK
Mutiara	Kebi
Sisi	Kebi
Diana	NLTK
Firasat	Kebi
Lai	Kebi
Banks	Lemmatization di nltk
Sammy	NLTK
Bacon	NLTK
Bhutia	NLTK
Mulia	Kebi
Dick	NLTK
Miss	Kebi
Fry	NLTK
Chevalier	NLTK
Deru	Kebi
Timothy	NLTK
Nash	NLTK
Joshua	NLTK
Camus	NLTK
Bam	Kebi
Rollo	NLTK
Jennifer	NLTK
Santo	Kebi
Benward	NLTK
Senat	Kebi
Louis	NLTK
Duda	Kebi
He	Kebi
Abbas	NLTK
Fey	NLTK
Roman	Kebi
KRU	Kebi
Terence	NLTK
R.A.	Satu kata bertitik
Khalifah	Kebi
Hadji	NLTK
Buisson	NLTK
Kipa	Kebi
Pure	Kebi
Harry	NLTK
PJ	Huruf Besar Semua
Gaspar	NLTK
Vista	Kebi
Anon	NLTK
Wolfram	Kebi
W.J.	Satu kata bertitik
Syafii	Kebi
Bowery	NLTK
Soto	Kebi
Gana	Kebi
Karen	NLTK
N	Kebi
Doddy	NLTK
Albright	NLTK
Rian	Kebi
Biz	NLTK
Railroad	NLTK
Puput	Kebi
Ci	Kebi
Samir	Kebi
Butane	NLTK
Biram	Kebi
Leak	Kebi
Aura	Kebi
Tera	Kebi
Ralf	NLTK
Yen	NLTK
Volts	Lemmatization di nltk
Yuan	NLTK
Iba	Kebi
Leung	NLTK
AC	Huruf Besar Semua
Betty	NLTK
Syah	Kebi
Oliphant	NLTK
Claude	NLTK
Brokoli	Kebi
Jade	NLTK
Log	Kebi
Muriel	NLTK
Vadim	NLTK
Kesuma	Kebi
Foreman	NLTK
Cok	Kebi
FM	Huruf Besar Semua
Swift	NLTK
Duk	Kebi
Ruan	Kebi
Pixie	NLTK
Ash	NLTK
Kinsman	NLTK
Sir	Kebi
Funeral	NLTK
Nate	NLTK
Spence	NLTK
Surya	Kebi
Hain	NLTK
Satria	Kebi
Carrick	NLTK
Gentile	NLTK
German	NLTK
A.A.	Satu kata bertitik
Jo	NLTK
Rai	Kebi
Costas	Lemmatization di nltk
Lyra	NLTK
Heidi	NLTK
Tarzan	Kebi
Bill	NLTK
Ganjar	Kebi
Rudd	NLTK
Graff	NLTK
Batari	Kebi
Wage	Kebi
Choky	NLTK
Relativisme	Kebi
Wen	NLTK
Dern	NLTK
Travis	NLTK
Lorenzo	NLTK
Bradbury	NLTK
Spice	NLTK
Harold	NLTK
Pena	Kebi
Vera	NLTK
Julio	NLTK
Christie	NLTK
Dorado	NLTK
Eveline	NLTK
Santiago	NLTK
Chow	NLTK
Sabrina	NLTK
Milan	NLTK
Piper	NLTK
Deep	NLTK
Dike	NLTK
Kempes	Kebi
Rancid	NLTK
Rosales	NLTK
Ade	NLTK
Pete	NLTK
Capote	NLTK
Limp	NLTK
Tour	NLTK
Micah	NLTK
Jiwa	Kebi
Privat	Kebi
Chicha	NLTK
Stuart	NLTK
Slot	NLTK
Edwin	NLTK
Truth	NLTK
Cho	NLTK
Jackson	NLTK
Moulin	NLTK
Claudia	NLTK
Crom	NLTK
Marion	NLTK
PUSHIM	Huruf Besar Semua
Katie	NLTK
Fatima	NLTK
V.	Satu kata bertitik
Countess	NLTK
Aban	Kebi
Polen	Kebi
Huckle	NLTK
KW	Huruf Besar Semua
Hiro	NLTK
Tim	Kebi
Pretty	NLTK
Cempaka	Kebi
by	NLTK
F.H.	Satu kata bertitik
Mambo	Kebi
Cates	Lemmatization di nltk
Orlando	NLTK
Amelia	NLTK
Dahlia	Kebi
Vienna	NLTK
Jose	NLTK
Longo	Kebi
Kitty	NLTK
Ace	NLTK
Bertram	NLTK
Forest	NLTK
Hilal	Kebi
P.V.	Satu kata bertitik
Dada	Kebi
Muir	NLTK
Nancy	NLTK
Eric	NLTK
Cecil	NLTK
Nila	Kebi
One	NLTK
Pahlavi	NLTK
Robert	NLTK
Sulung	Kebi
Reddy	NLTK
Audio	Kebi
Gus	Kebi
Run	NLTK
Iwa	NLTK
Pike	Kebi
Kopral	Kebi
Andung	Kebi
JJ	Huruf Besar Semua
Stain	NLTK
Kurt	NLTK
Mafia	Kebi
Costa	NLTK
Julian	NLTK
Teologi	Kebi
Delap	Kebi
Marshall	NLTK
Oar	NLTK
Malcolm	NLTK
Freeman	NLTK
Gori	Kebi
Peters	Lemmatization di nltk
Wes	NLTK
Phoenix	NLTK
Panda	NLTK
Gilas	Kebi
Rio	NLTK
Pasha	NLTK
Isra	Kebi
Nicholas	NLTK
Hazard	NLTK
Smuts	Lemmatization di nltk
Babel	NLTK
Dadi	Kebi
Pranata	Kebi
Fire	NLTK
Card	NLTK
Ary	NLTK
Burak	Kebi
Bent	NLTK
Wanita	Kebi
Madonna	NLTK
Hicks	Lemmatization di nltk
Re	Kebi
Toon	NLTK
Kroto	Kebi
Georgie	NLTK
Daming	Lemmatization di nltk
Kota	Kebi
Bodo	NLTK
Mang	Kebi
Pander	NLTK
Acoustic	NLTK
Grange	NLTK
Tugas	Kebi
Dulles	Lemmatization di nltk
Overload	NLTK
Danic	NLTK
Shoji	NLTK
Gafur	Kebi
Selah	NLTK
Eurythmics	NLTK
Mauri	NLTK
Babu	Kebi
Peri	Kebi
August	NLTK
Alicia	NLTK
Sessions	NLTK
Stella	NLTK
Gendut	Kebi
Fink	NLTK
Esa	Kebi
Clara	NLTK
Jakob	NLTK
Neville	NLTK
Mori	Kebi
Wanda	Kebi
Anom	Kebi
Iso	NLTK
Marilyn	NLTK
Alphonso	NLTK
Daman	Kebi
Shadows	Lemmatization di nltk
PAS	Kebi
M	Kebi
Hysteric	NLTK
Bonet	Kebi
Franks	Lemmatization di nltk
Sar	Kebi
Sufi	Kebi
Hawking	NLTK
Amina	Kebi
Tino	NLTK
Valentine	NLTK
Amir	Kebi
Camara	NLTK
Melissa	NLTK
Lux	NLTK
Vamps	Lemmatization di nltk
Monte	NLTK
Hidayat	Kebi
Hetman	NLTK
Revolver	Kebi
Batik	Kebi
Keyes	Lemmatization di nltk
Mino	NLTK
Money	NLTK
Reda	Kebi
Melody	NLTK
Tamara	NLTK
Fernando	NLTK
Ibo	NLTK
Oleg	NLTK
Rani	Kebi
Zein	NLTK
Rahmat	Kebi
Arenas	Lemmatization di nltk
Pompadour	NLTK
Ladin	NLTK
E.G.	Satu kata bertitik
Angga	Kebi
Bruno	NLTK
Axel	NLTK
Bukan	Kebi
Damar	Kebi
Anang	Kebi
Dearly	NLTK
Felix	NLTK
Boer	NLTK
Penta	NLTK
Bright	NLTK
Alice	NLTK
Minum	Kebi
Takeuchi	NLTK
Clift	NLTK
Archer	NLTK
Walker	NLTK
Ora	NLTK
Leo	Kebi
Courtney	NLTK
Ko	NLTK
Permata	Kebi
Generation	NLTK
Brands	Lemmatization di nltk
Elvira	NLTK
Fowler	NLTK
Palmer	NLTK
Jeffery	NLTK
Albee	NLTK
Intan	Kebi
Bonnie	NLTK
Topsy	NLTK
Sissy	NLTK
Jesse	NLTK
Genevieve	NLTK
Ayunda	Kebi
Sebai	Kebi
Parks	Lemmatization di nltk
Pontus	NLTK
al	Kebi
Aurelia	NLTK
Sumitro	NLTK
Horn	NLTK
Bale	NLTK
Eliza	NLTK
Nada	Kebi
Foray	NLTK
Barton	NLTK
Laine	NLTK
Bennet	NLTK
Derby	NLTK
Dixie	NLTK
Holla	NLTK
Belo	Kebi
Krista	Kebi
Grab	NLTK
Jaime	NLTK
Sosiawan	Kebi
Guti	NLTK
Gajah	Kebi
Garnet	Kebi
oleh	Kebi
Jesper	NLTK
Bundy	NLTK
Perdana	Kebi
JUMP	NLTK
Pangeran	Kebi
Mira	NLTK
A.R.	Satu kata bertitik
Hood	NLTK
SISTAR	Huruf Besar Semua
Penelope	NLTK
Anil	Kebi
Room	NLTK
K.K.	Satu kata bertitik
Pierre	NLTK
Tengker	Kebi
Ronald	NLTK
Caecilia	NLTK
Dusky	NLTK
Gama	Kebi
Filo	Kebi
Kanjeng	Kebi
Rahim	Kebi
Elvis	NLTK
R.Hartono	Satu kata bertitik
Chin	NLTK
Anduk	Kebi
Lea	NLTK
Zinnia	NLTK
Helm	Kebi
Billy	NLTK
Jed	NLTK
Dominic	NLTK
Hatta	Kebi
Jati	Kebi
Toby	NLTK
Bert	NLTK
Five	NLTK
Sonic	NLTK
Alya	NLTK
Barry	NLTK
Nia	Kebi
F	NLTK
Culver	NLTK
Jive	NLTK
Lohan	NLTK
Moudy	NLTK
Wales	Lemmatization di nltk
Leon	NLTK
Robles	Lemmatization di nltk
Tina	NLTK
Love	NLTK
Tara	Kebi
Short	NLTK
Bagong	Kebi
Babys	Lemmatization di nltk
P	NLTK
Florian	NLTK
Sync	NLTK
Dao	NLTK
Karas	Kebi
Steno	Kebi
Bryan	NLTK
Beck	NLTK
Tji	NLTK
Naoto	NLTK
Feri	Kebi
yang	Kebi
Dudu	Kebi
Trillo	NLTK
E	Kebi
Ros	Kebi
Aksa	Kebi
Simson	NLTK
Ulysses	NLTK
Merry	NLTK
Barel	Kebi
Can	NLTK
Merton	NLTK
Coda	NLTK
Ibnu	Kebi
Soul	NLTK
Symphony	NLTK
Jaguar	Kebi
Michel	NLTK
Elang	Kebi
River	NLTK
Tasa	Kebi
REO	Huruf Besar Semua
Stoker	Kebi
Kembara	Kebi
Riot	NLTK
Jessie	NLTK
Mitchell	NLTK
Mursyid	Kebi
Lars	Kebi
Holiday	NLTK
Clark	NLTK
Styles	Lemmatization di nltk
Phoebe	NLTK
Shire	NLTK
Ranty	NLTK
Wu	NLTK
Antar	Kebi
Jeffrey	NLTK
Gasser	NLTK
Cooper	NLTK
Dorothy	NLTK
Darin	NLTK
Galung	Kebi
Moore	NLTK
Malih	Kebi
Messing	NLTK
Elias	NLTK
Jill	NLTK
Danuri	NLTK
Landers	Lemmatization di nltk
Salva	NLTK
Baba	Kebi
Root	NLTK
Heart	NLTK
Kenneth	NLTK
Gwen	NLTK
Bradford	NLTK
Temptation	NLTK
Mew	NLTK
Frances	NLTK
Oliver	NLTK
Ansel	NLTK
Abas	NLTK
di	Kebi
Bongo	Kebi
Adil	Kebi
Olof	NLTK
Sting	NLTK
Graves	NLTK
Cucu	Kebi
Conor	NLTK
Zach	NLTK
Ava	NLTK
Marcella	NLTK
Day	NLTK
Lins	Lemmatization di nltk
Tunas	Kebi
Karina	Kebi
Ferry	NLTK
Vic	NLTK
van	NLTK
Schiller	NLTK
Dena	Kebi
Don	Kebi
Incubus	NLTK
Carolyn	NLTK
